# BORNEO ID - Note: We excluded this because Borneo could be both Indonesia or Malaysia
# SABA & SABA ISLAND - Note: We excluded these because they could either mean the state of Sabah in Malaysia (MY) or the island of Saba in the Carribean (BQ)
A FEW MILES OFFSHORE OF LA SPEZIA ITALY	IT
AALST BELGIUM	BE
AALTER BELGIUM	BE
ABERDEEN SCOTLAND	GB
ABESSINIÃ	ET
ABESSYNIA	ET
ABUARBI SHIGA PREF JAPAN	JP
ABW	AW
ABYSSINE ETHIOPIA	ET
ACE LAKE VESTFOLD HILLS ANTARCTICA	AQ
ADELAIDE IS	AQ
ADMIRALTY BAY KING GEORGE ISLAND SOUTH SHETLAND ISLANDS ANTARCTICA	AQ
ADMIRALTY IS	US
AFG	AF
AFGANISTÁN	AF
AFGHANISTAN	AF
AFRIQUE DU SUD	ZA
AFRIQUE DU SUD BANTU	ZA
AFRIQUE DU SUD BASUTOLAND SOTHO	ZA
AFRIQUE DU SUD BOTSWANA KGATHA	BW
AFRIQUE DU SUD LOBEDU	ZA
AFRIQUE DU SUD MFENGU	ZA
AFRIQUE DU SUD MPONDOZULU LALA	ZA
AFRIQUE DU SUD PAYS VENDA	ZA
AFRIQUE DU SUD SOTHO	ZA
AFRIQUE DU SUD SOTHO DU BASUTOLAND	ZA
AFRIQUE DU SUD SOTHO LOBEDU ZULU	ZA
AFRIQUE DU SUD SOTHO NGUNI	ZA
AFRIQUE DU SUD SWAZILANDSWATI	ZA
AFRIQUE DU SUD TRANSVAAL ORIENTAL	ZA
AFRIQUE DU SUD XHOSA	ZA
AFRIQUE DU SUD XHOSA ET MFENGU	ZA
AFRIQUE DU SUD ZIMBABWE NDEBELE	ZW
AFRIQUE DU SUD ZULU	ZA
AFRIQUE DU SUD ZULU KWENA	ZA
AFRIQUE DU SUD ZULU SWATI	ZA
AFRIQUE SUD	ZA
AFRIQUE SUD ET EST GUINÃE CONAKRY FOUTADJALLON	GN
AGALEGA IDS	MU
AGO	AO
AIA	AI
AICHI JAPAN	JP
AISNE FRANCE	FR
AJUY ILTOILO PHILIPPINES	PH
ALA	AX
ALABAMA	US
ALABAMA USA	US
ALAGOAS BRAZIL	BR
ALASKA	US
ALASKA USA	US
ALB	AL
ALBANIA	AL
ALBANIE	AL
ALBERTON SOUTH AFRICA	ZA
ALDABRA	SC
ALDERLEY BRISBANE AUSTRALIA	AU
ALEMANIA	DE
ALEUTIAN ISL	US
ALEXANDRIA EGYPT	EG
ALGERIE	DZ
ALGERIÃ	DZ
ALGIERS	DZ
ALGÉRIE	DZ
ALICANTE SPAIN	ES
ALLEMAGNE	DE
AMAKUSA NAGASAKI PREF JAPAN	JP
AMALIAS GREECE	GR
AMER SAMOA	AS
AMERICAN SAMOA USA	AS
AMERICANSAMOA	AS
AMPONVILLE FRANCE	FR
AMSAMOA	AS
AMSTERDAM	NL
AMSTERDAM I	TF
AMSTERDAM THE NETHERLANDS	NL
AND	AD
ANDAMAN IS	IN
ANDAMAN ISL	IN
ANDORRA	AD
ANDORRE	AD
ANGOLA	AO
ANGOLA EXCLAVE	AO
ANGUILA	AI
ANGUILLA	AI
ANT	AN
ANTACTICA	AQ
ANTAGUA	AG
ANTARCTIC	AQ
ANTARCTICA ÂS	AQ
ANTARCTIQUE	AQ
ANTARTICA	AQ
ANTIGUA	AG
ANTIGUA AND BARABU	AG
ANTIGUA BARB	AG
ANTIGUA ET BARBUDA	AG
ANTIGUA Y BARBUDA	AG
ANTIGUA-ET-BARBUDA	AG
ANTILLAS NEERLANDESAS	AN
ANTIQUA	AG
ANTWERP BELGIUM	BE
ANTWERPEN BELGIUM	BE
ANTÁRTIDA	AQ
APARRI CAGAYAN PHILIPPINES	PH
APPALACHICOLA BAY TALLAHASSEE	US
ARABIA	SA
ARABIA SAUDITA	SA
ARABIE SAOUDITE	SA
ARDENNES BELGIUM	BE
ARDÃCHE FRANCE	FR
ARE	AE
ARG	AR
ARGELIA	DZ
ARGENTANIÃ	AR
ARGENTINA	AR
ARGENTINE	AR
ARGENTINIA	AR
ARGENTIÃ	AR
ARGETON BRITTANY FRANCE	FR
ARHUS DENMARK	DK
ARIZONA	US
ARIZONA USA	US
ARKANSAS USA	US
ARM	AM
ARMENIA	AM
ARMENIA RUSSIA	AM
ARMENIYA	AM
ARMÉNIE	AM
ARUBA	AW
ASCENSION	SH
ASCENSION I	SH
ASCENSION ID	SH
ASCHAFFENBURG GERMANY	DE
ASERBSSR	AZ
ASHBURTON NEW ZEALAND	NZ
ASM	AS
ASSAM	IN
ASSE BELGIUM	BE
ASTORP SWEDEN	SE
ASTRIA	AT
ATA	AQ
ATF	TF
ATG	AG
ATLANTA USA	US
ATSUGISHI KANAGAWA JAPAN	JP
ATSUMA HOKKAIDO JAPAN	JP
AU CF	AU
AUDE FRANCE	FR
AUGUSTA USA	US
AUNUU ISLAND	AS
AUS	AU
AUSTALIA	AU
AUSTEVOLL NORWAY	NO
AUSTRAILIA	AU
AUSTRAL ISLANDS	PF
AUSTRALIA	AU
AUSTRALIA EASTERN	AU
AUSTRALIE	AU
AUSTRIA	AT
AUT	AT
AUTRICHE	AT
AVIAN UK	GB
AYRSHIRE SCOTLAND	GB
AZE	AZ
AZERBAIDZHAN	AZ
AZERBAIYÁN	AZ
AZERBAYDZHAN	AZ
AZERBAÏDJAN	AZ
AZORERNA	PT
AZORES	PT
AZORES IS	PT
AÃORES	PT
BAHAMA	BS
BAHAMA ID	BS
BAHAMA IDS	BS
BAHAMA ISLANDS	BS
BAHAMAS	BS
BAHAMAS IDS	BS
BAHAMAS ISLANDS	BS
BAHAMAS THE	BS
BAHIA BRAZIL	BR
BAHREIN	BH
BAHREÏN	BH
BAHRÉIN	BH
BALEARES	ES
BALI	ID
BALINGKAWAYAN SAN JOSE TARLAC TARLAC PHILIPPINES	PH
BALTIMORE USA	US
BAMBERG GERMANY	DE
BANAUE SIK IFUGAO PHILIPPINES	PH
BANDOENG INDONESIA	ID
BANGLADESH	BD
BANGOR UK	GB
BANTUG MUNOZ NUEVA ECIJA PHILIPPINES	PH
BARBADE	BB
BARBADOS	BB
BARBUDA	AG
BARBUDA ISLAND	AG
BARZIL	BR
BAWANA NEAR DELHI INDIA	IN
BAY	DE
BAY OF PANAMA	PA
BDI	BI
BEAR ISLAND	NO
BEAUNE FRANCE	FR
BECQUEVOORT BELGIUM	BE
BEDFORDSHIRE UK	GB
BEERNEM BELGIUM	BE
BEERSE BELGIUM	BE
BEHRANG MALAYSIA	MY
BEIJING CHINA	CN
BEL	BE
BELARUS	BY
BELAU	PW
BELFAST EASTERN TRANSVAAL SOUTH AFRICA	ZA
BELGIAN CONGO	CD
BELGIQUE	BE
BELGIUM AALTER	BE
BELGIUM AMYLUM	BE
BELICE	BZ
BELIZE	BZ
BELLE GLADE FLORIDA USA	US
BELUDSCHISTAN	PK
BEN	BJ
BENIM	BJ
BENÍN	BJ
BERKELEY CALIFORNIA USA	US
BERKELEY USA	US
BERLINBUCH GERMANY	DE
BERMUDAS	BM
BERMUDES	BM
BERNE SWITZERLAND	CH
BERNUDA	BM
BETHLEHEM USA	US
BFA	BF
BGD	BD
BGR	BG
BHOUTAN	BT
BHR	BH
BHS	BS
BIELORRUSIA	BY
BIH	BA
BINH THANH VIETNAM	VN
BIOKO	CM
BIRMANIA	MM
BIRMANIE	MM
BIÉLORUSSIE	BY
BLACK SEA RUSSIA	RU
BLACKPOOL UK	GB
BLACKSBURG USA	US
BLANKVANN NORWAY	NO
BLELHAM TARN UK	GB
BLR	BY
BLZ	BZ
BMU	BM
BOEKHOUT BELGIUM	BE
BOGOR INDONESIA	ID
BOL	BO
BOLIVA	BO
BOLIVIA	BO
BOLIVIE	BO
BOLIVIE, l'ÉTAT PLURINATIONAL DE	BO
BOMBAY INDIA	IN
BONAIRE	BQ
BONAIRE THE NETHERLANDS ANTILLES	AN
BONAIRE, SAINT-EUSTACHE ET SABA	BQ
BONDY FRANCE	FR
BONNEVILLE DAM COLUMBIA RIVER WASHINGTON USA	US
BORDEAUX FRANCE	FR
BORDEAUX GIRONDE FRANCE	FR
BORGLOON BELGIUM	BE
BORNHOLM BALTIC SEA	DK
BORSTEL GERMANY	DE
BORÃS SWEDEN	SE
BOSNIA	BA
BOSNIA AND HERCEGOVINA	BA
BOSNIA HERCEGOVINA YUGOSLAVIA	BA
BOSNIA HERZG	BA
BOSNIA Y HERZEGOVINA	BA
BOSNIAHERCEGOVINA	BA
BOSNIE	BA
BOSNIE-HERZÉGOVINE	BA
BOSNIÃ	BA
BOSTON MASSACHUSETTS USA	US
BOTANICAL GARDEN KYOTO JAPAN	JP
BOTSUANA	BW
BOTSWANA	BW
BOTSWANA KALAHARI	BW
BOTSWANA KALAHARI CENTRAL	BW
BOTSWANA KGATHA	BW
BOUGAINVILLE	PG
BOURGENBRESSE FRANCE	FR
BOUVET	BV
BOUVET IS	BV
BOUVET, ÎLE	BV
BR IND OC TR	IO
BR VIRGIN IS	VG
BRA	BR
BRADFORT UK	GB
BRAINE LALLEUD BELGIUM	BE
BRASIL	BR
BRAUNSCHWEIG GERMANY	DE
BRB	BB
BRCES PILI CAMARINES SUR PHILIPPINES	PH
BRISTOL UK	GB
BRIT ANTAR TER	AQ
BRITAIN	GB
BRITAIN UK	GB
BRITISH COLUMBIA CANADA	CA
BRITISH GUIANA	GY
BRITISH HONDURAS	HN
BRITISH VIRGIN ID	VG
BRITISH VIRGIN IDS	VG
BRITISH VIRGIN ISLANDS	VG
BRITISH VIRGIN ISLS	VG
BRITISH VRIGIN IDS	VG
BRN	BN
BRUGELETTE BELGIUM	BE
BRUGGE BELGIUM	BE
BRUNEI	BN
BRUNEI DARSM	BN
BRUNEI DARUSSALAM	BN
BRUNEIDARUSSALAM	BN
BRUNÉI	BN
BRUSSEL BELGIUM	BE
BRUSSELS BELGIUM	BE
BRUXELLES	BE
BRÉSIL	BR
BTN	BT
BUFFALO NEW YORK USA	US
BUGGENHOUT BELGIUM	BE
BUGUEY CAGAYAN PHILIPPINES	PH
BULG	BG
BULGARIA	BG
BULGARIE	BG
BURGARIJE	BG
BURKINA	BF
BURKINA FASO	BF
BURKINA FASO PLATEAU CENTRAL	BF
BURKINA FASO ZONE SAHEL amp SOUDANOSAHEL	BF
BURKINAFASO	BF
BURKINAFASO PROVINCE DU PASSORÃ	BF
BURKINO FASO	BF
BURMA	MM
BURMA NO LONGER EXISTS	MM
BURMINGHAM ENGLAND	GB
BURNT CREEK CANADIAN FAR NORTH	CA
BURTON LAKE ANTARTICA	AQ
BURUNDI	BI
BURUNDI CRÃªTES ZAÃRENIL	BI
BURUNDI KIRIMIRONORD	BI
BURUNDI OCCIDENTAL	BI
BUTÁN	BT
BVT	BV
BWA	BW
BWAMANDA ZAIRE	CD
BÃNIN	BJ
BÃNIN MONO	BJ
BÉLARUS	BY
BÉLGICA	BE
BÉLIZE	BZ
BÉNIN	BJ
CABINDA	AO
CABO VERDE	CV
CABRERA ISLAND	ES
CAF	CF
CAGLIARI ITALY	IT
CAIRO EGYPT	EG
CALIFORNIA	US
CALIFORNIA USA	US
CALIFORNIÃ	US
CALLENELLE BELGIUM	BE
CAMAROON	CM
CAMBERENE SENEGAL	SN
CAMBODGE	KH
CAMBODJA	KH
CAMBOGE	KH
CAMBOYA	KH
CAMBRIDGE UK	GB
CAMEROONS	CM
CAMEROUN	CM
CAMEROUN NORDEST	CM
CAMEROUN PROVINCE DU NORDOUEST PEUPLE FULANI	CM
CAMERÚN	CM
CAMPINAS BRAZIL	BR
CAN	CA
CAN BR COLUM	CA
CAN MARITIMS	CA
CAN NEWFOUNL	CA
CAN QUEBEC	CA
CANAD	CA
CANADA	CA
CANADA ALBERTA COLD CREE	CA
CANADA ALBERTA PROSPECT CREE	CA
CANADA CAVEN LAK	CA
CANADA ONTARIO	CA
CANADA USA	CA
CANADIAN FAR NORTH	CA
CANADÁ	CA
CANAL ZONE PANAMA	PA
CANARY IS	ES
CANARY ISLANDS	ES
CANAS PUERTO RICO	PR
CANDA	CA
CANOE BEACH TEMA GHANA	GH
CAP VERDE ISLANDS	CV
CAP VERT	CV
CAP-VERT	CV
CAPE VERDE IDS	CV
CAPE VERDE ISLANDS	CV
CAPEVERDE	CV
CAPOY SORSOGON SORSOGON PHILIPPINES	PH
CARANISCHE EILANDEN	ES
CARDIFF WALES	GB
CARGADOS CARAJOS	MU
CARIMAGUA COLOMBIA	CO
CASIGAN NARRA PALAWAN PHILIPPINES	PH
CAUCASUS RUSSIA	RU
CAUGHT OFF THE NORTH CAPE OF NORWAY	NO
CAYMAN	KY
CAYMAN IDS	KY
CAYMAN IS	KY
CAYMEN IDS	KY
CAÏMANS, ÎLES	KY
CCK	CC
CELEBES	ID
CENT AFR REP	CF
CENTRAFRICA REPUBLIC	CF
CENTRAFRICAINE, RÉPUBLIQUE	CF
CENTRAFRICAN REPUBLIC	CF
CENTRAFRIQUE	CF
CENTRAL AFRICA REPUBLIC	CF
CENTRAL AFRICAN REP	CF
CENTRAL CROPS RESEARCH STATION CLAYTON NORTH CAROLINA USA	US
CENTRAL EXPERIMENTAL FARM OTTAWA ONTARIO CANADA	CA
CENTRAL JAVA INDONESIA	ID
CENTRAL LITHUANIA	LT
CENTRE AFRIQUE RÃGION DE LA LOBAYE OUBANGICHARI	CF
CERNIKA	SI
CEYLON	LK
CEYLON SRI LANKA	LK
CF ZAIRE	CD
CHAD	TD
CHAGOS ARCHIPELAGO	IO
CHAGOS IS	IO
CHALK REGION KENT UK	GB
CHANNEL IS	GB
CHANNEL ISL	GB
CHANNEL ISLANDS	GB
CHANNEL ISLANDS UK	GB
CHARENTES MARITIMES FRANCE	FR
CHARLEROI BELGIUM	BE
CHARLEVILLE FRANCE	FR
CHE	CH
CHECH REPUBLIC	CZ
CHESAPEAKE BAY MARYLAND USA	US
CHETNEY MARSHES KENT UK	GB
CHICAGO USA	US
CHIEMSEE BAVARIA GERMANY	DE
CHILE	CL
CHILES	CL
CHILI	CL
CHIMAY	BE
CHINA	CN
CHINA KITAY	CN
CHINA MAIN	CN
CHINA PR	CN
CHINE	CN
CHINEESTURKESTAN	CN
CHIPRE	CY
CHL	CL
CHN	CN
CHRISTMAS I	CX
CHRISTMAS ID	CX
CHRISTMAS, ÎLE	CX
CHYPRE	CY
CINCINNATI USA	US
CITY AIRPORT GUATEMALA	GT
CIUDAD DEL VATICANO	VA
CIV	CI
CLARKE RESERVATION NEW YORK USA	US
CLERMONTFERRAND	FR
CLEVELAND USA	US
CLINKER GULCH SOUTH SANDWICH ISLANDS	GS
CLIPPERTON I	PF
CLIPPERTON ID	PF
CLIPPERTON ISLAND	PF
CMR	CM
COAS OF LIBERIA	LR
COCOS (KEELING), ÎLES	CC
COCOS I CR	CC
COCOS IDS	CC
COCOS IS	CC
COCOS ISL	CC
COCOS ISLANDS	CC
COD	CD
COG	CG
COK	CK
COL	CO
COLCHESTER ENGLAND	GB
COLMAR FRANCE	FR
COLOMBIA	CO
COLOMBIE	CO
COLOMIA	CO
COLORADO	US
COLORADO SPRINGS COLORADO USA	US
COLORADO USA	US
COLUMBIA	CO
COLUMBIEN	CO
COM	KM
COMMONWEALTH OF THE NORTHERN MARIANA IS	MP
COMMONWEALTH OF THE NORTHERN MARIANA ISLANDS	US
COMORAS	KM
COMOREN ISL	KM
COMORES	KM
COMORO ISLANDS	KM
CONGO	CD
CONGO AFRICA	CD
CONGO BELGE RÃP DÃMOCRATIQUE DU CONGO	CD
CONGO BRAZZAVILLE	CG
CONGO DEM REP	CD
CONGO DEMOCRATIC REPUBLIC	CD
CONGO DR	CD
CONGO FREE STATE	CD
CONGO KINSHASA	CD
CONGO LEOPOLDVILLE	CD
CONGO REP	CD
CONGO RÃP POPULAIRE DU CONGO	CG
CONGO, LA RÉPUBLIQUE DÉMOCRATIQUE DU	CD
CONGOKINSHASA	CD
CONGOLEOPOLDVILLE	CD
CONNECTICUT USA	US
CONTREXEVILLE PAVILLON SPRING FRANCE	FR
COOK IS	CK
COOK ISL	CK
COOK ISLAND	CK
COOK ISLANDS	CK
COOK, ÎLES	CK
COOKISLANDS	CK
COOS COUNTRY OREGON USA	US
COPENHAGEN DENMARK	DK
CORAL SEA AUSTRALIA	AU
COREA DEL NORTE	KP
COREA DEL SUR	KR
CORINTH GREECE	GR
CORSICA	FR
CORSICA FRANCE	FR
CORÉE DU NORD	KP
CORÉE DU SUD	KR
CORÉE, RÉPUBLIQUE DE	KR
CORÉE, RÉPUBLIQUE POPULAIRE DÉMOCRATIQUE DE	KP
COSTA DE MARFIL	CI
COSTA RICA	CR
COSTA RICO	CR
COSTA ROCA	CR
COSTARICA	CR
COTE D	CI
COTE DIVOIRE	CI
COTE DIVOIRE IVORY COAST	CI
COTEDIVOIRE	CI
CPV	CV
CRETE	GR
CRETE GREECE	GR
CRI	CR
CROACIA	HR
CROATIA HRVATSKA	HR
CROATIE	HR
CROIX SCAILLE BELGIUM	BE
CROIXSCAILLE BELGIUM	BE
CROYDON UK	GB
CROZET IS	TF
CRYSTAL LAKE ILLINOIS USA	US
CUB	CU
CUBA	CU
CULAPE LUCBAN QUEZON PHILIPPINES	PH
CURACAO	AN
CURACOS	AN
CURAO	AN
CURAÃAO	AN
CURAÃAO I	AN
CURAÇAO	CW
CURAÏAO	AN
CURAÏAO I	AN
CXR	CX
CYM	KY
CYP	CY
CZE	CZ
CZECH REP	CZ
CZECH RUPUBLIC	CZ
CZECHIA	CZ
CÃTE DIVOIRE	CI
CÃTE SAINT ANDRÃ FRANCE	FR
CÃVENNES FRANCE	FR
CÔTE D'IVOIRE	CI
DAHOMEY	BJ
DAKAR BEL AIR SENEGAL	SN
DALLAS USA	US
DANDERYD SWEDEN	SE
DANEMARK	DK
DANMARK	DK
DAQING VALLEY TONGLIAO MONGOLIA CHINA	MN
DARESSALAAM	TZ
DARTMOOR UK	GB
DAVIS CALIFORNIA USA	US
DE BLANKAART BELGIUM	BE
DEAD SEA	IL
DEAD SEA ISRAEL	IL
DEATH VALLEY CALIFORNIA USA	US
DEE RIVER CHESHIRE UK	GB
DEHLI INDIA	IN
DELFT THE NETHERLANDS	NL
DELTA AREA EGYPT	EG
DEMOCRATIC PEOPLES REPUBLIC OF KOREA	KP
DEMOCRATIC REPUBLIC OF CONGO	CD
DEMOCRATIC REPUBLIC OF THE CONGO	CD
DEMOCRATIC YEMEN	YE
DEN HAAG THE NETHERLANDS	NL
DENEMARKEN	DK
DENMARK	DK
DENMARK FAEROE ISLANDS	FO
DENMARK GREENLAND	GL
DEPT BACT COUNTY HOSPITAL GYULA HUNGARY	HU
DEU	DE
DEUTSCHLAND	DE
DEUX SÃVRES FRANCE	FR
DIABALI NIONO MALI	ML
DIEU LOUARD MEURTHE ET MOSELLE FRANCE	FR
DIEULOUARD FRANCE	FR
DINAMARCA	DK
DIWANIYAH QADISYA AREA IRAQ	IQ
DJI	DJ
DJIBOUTI	DJ
DMA	DM
DNK	DK
DOEL BELGIUM	BE
DOM	DO
DOMICAN REPUBLIC	DO
DOMINICA	DM
DOMINICA ISLAND	DM
DOMINICAINE, RÉPUBLIQUE	DO
DOMINICAN REPEBLIC	DO
DOMINICAN REPUBLIC	DO
DOMINICAN REUBLIC	DO
DOMINICAN RP	DO
DOMINICANREPUBLIC	DO
DOMINIQUE	DM
DOMMICAN REPUBLIC	DO
DORO WAKAYAMA PREF JAPAN	JP
DOUALA CAMEROON	CM
DOWNE UK	GB
DR CONGO	CD
DRC	CD
DREISAM RIVER FREIBURG GERMANY	DE
DRESUND DENMARK	DK
DROGENBOS BELGIUM	BE
DUBLIN IRELAND	IE
DUISTLAND	DE
DUITLAND	DE
DURHAM USA	US
DUTCH WEST INDIES	AN
DZA	DZ
E AUSTRALIA	AU
E POLYNESIA	PF
E POLYNESIA SOCIETY IS	PF
EAST AUSTRALIA	AU
EAST CHINA	CN
EAST GERMANY	DE
EAST INDIA	IN
EAST MALAYSIA	MY
EAST POLYNESIA	PF
EAST TURKEY	TR
EASTER I	CL
EASTER ISL	CL
EASTER ISLAND	CL
EASTERN KAVANGO NAMIBIA	NA
EAUSTRALIA	AU
EBOLIVIA	BO
EC CF	EC
ECU	EC
ECUADOR	EC
ECUADOR GALAPAGOS ISLANDS	EC
EDINBURGH UK	GB
EDOMINICA	DM
EEKLO BELGIUM	BE
EERNEGEM GISTEL BELGIUM	BE
EGEM BELGIUM	BE
EGIPTO	EG
EGY	EG
EGYPTE	EG
EHIME JAPAN	JP
EIRE	IE
EKHO LAKE VESTFOLD HILLS EAST ANTARCTICA	AQ
EL FAU SUDAN	SD
EL OBEID SUDAN	SD
EL SALVADOR	SV
EL SALVODOR	SV
ELLIGNIES BELGIUM	BE
ELSALVATOR	SV
EMIGRATION CANYON SALT LAKE CITY UTAH USA	US
EMIRATOS ÁRABES UNIDOS	AE
EMPIRE CENTRAFRICAIN RÃPUBLIQUE CENTRAFRICAINE	CF
ENG	GB
ENGL	GB
ENGL IREL	GB
ENGLAND	GB
ENGLAND UK	GB
ENGLISH	GB
EPHESUS TURKEY	TR
EPIRUS GREECE	GR
EPOLYNESIA	PF
EQ GUINEA	GQ
EQUADOR	EC
EQUAT GUINEA	GQ
EQUATORIALGUINEA	GQ
ERI	ER
ERITHREA	ER
ERITREA	ER
ERNAKULUM INDIA	IN
ERQUELINES BELGIUM	BE
ERYTHRÃE	ER
ESBJERG DENMARK	DK
ESH	EH
ESLOVAQUIA	SK
ESLOVENIA	SI
ESP	ES
ESPAGNE	ES
ESPAÑA	ES
ESSLINGEN GERMANY	DE
EST	EE
ESTADOS UNIDOS	US
ESTONIA	EE
ESTONIA USSR	EE
ESTONIE	EE
ET ABESSINIE	ET
ETH	ET
ETHIOPA	ET
ETHIOPIE	ET
ETHIOPIE CENTRALE	ET
ETHIOPIE NORDEST RÃGION DU GONDAR	ET
ETHIOPIE VALLÃE DE LAWASH	ET
ETHIPOIA	ET
ETIOPÍA	ET
EU FRANCE	FR
EUCADOR	EC
EVIAN CACHAT SPRING FRANCE	FR
EXETER UK	GB
FAEROE IS	FO
FAEROE ISL	FO
FAEROE ISLANDS	FO
FALKLAND IDS	FK
FALKLAND IS	FK
FALKLAND ISL	FK
FALKLAND ISLANDS	FK
FALKLAND ISLANDS AND DEPENDENCIES	FK
FALKLAND, ÎLES (MALVINAS)	FK
FAUQUIER COUNTY VIRGINIA USA	US
FED ST MICRONESIA	FM
FEDERAL REPUBLIC OF GERMANY	DE
FEDERATED STATE OF MICRONESIA	FM
FEDERATED STATES MICONESIA	FM
FEDERATED STATES OF MICONESIA	FM
FEDERATED STATES OF MICRONESIA	FM
FEDERATIVE REPUBLIC OF BRAZIL	BR
FEDSTATES OF MICRONESIA	FM
FIDJI	FJ
FIJI ISLANDS	FJ
FILIPINAS	PH
FIN	FI
FINISTÃRE FRANCE	FR
FINLANDE	FI
FINLANDIA	FI
FIYI	FJ
FJI	FJ
FJORDS NORWAY	NO
FLANNAN ISLES SCOTLAND	GB
FLK	FK
FLOREFFE	BE
FLORIDA	US
FLORIDA EVERGLADES USA	US
FLORIDA USA	US
FORMER USSR	RU
FORMOSA	TW
FORT PRINCE OF WALES HUDSON BAY CANADA	CA
FR GUIANA	GF
FR POLYNESIA	PF
FRA	FR
FRANCE	FR
FRANCE PROGIL LAB	FR
FRANCE SW	FR
FRANCIA	FR
FRANEC	FR
FRANKCE	FR
FRANKLIN CITY CHESAPEAKE BAY USA	US
FRDERIKSBERG COPENHAGEN DENMARK	DK
FREEHOLD NEW YERSEY USA	US
FREIBURG GERMANY	DE
FREISING GERMANY	DE
FRENCH GUINEA	GF
FRENCH GUYANA	GF
FRENCHGUIANA	GF
FRESNO COUNTY CALIFORNIA USA	US
FRMARQUESAS ISLANDS	PF
FRNCE	FR
FRO	FO
FRYDEKMISTEK CZECH REPUBLIC	CZ
FRYDEKMISTEK CZECHOSLOVAKIA	CZ
FRÃVENT FRANCE	FR
FSM	FM
FTVALLEY USA	US
FUENTEVENTURA	ES
FUERTEVENTURA	ES
FUTUNA	WF
FUZHOU CHINA	CN
FÉDÉRATION DE RUSSIE	RU
FÉROÉ, ÎLES	FO
GAB	GA
GABON	GA
GABÓN	GA
GAEIL	GB
GALAPAGOS IDS	EC
GALAPAGOS IS	EC
GALAPAGOS ISLAND	EC
GALAPAGOS ISLANDS	EC
GALPAGOS	EC
GAMBIA	GM
GAMBIE	GM
GAMBIER ISL	CA
GANSU REPUBLIC OF CHINA	CN
GBR	GB
GEEL BELGIUM	BE
GEMBLOUX BELGIUM	BE
GENAPPE BELGIUM	BE
GEO	GE
GEORGIA	GE
GEORGIA ATLANTA USA	US
GEORGIA USA	US
GEOTHERMAL AREA ICELAND	IS
GERAARDSBERGEN BELGIUM	BE
GERMAN DR NO LONGER EXISTS	DE
GERMANY	DE
GERMANY EAST GERMANY	DE
GERMANY FEDERAL REPUBLIC OF	DE
GERMANY WEST	DE
GERMANY WEST GERMANY	DE
GERMAY	DE
GEYSIR ICELAND	IS
GGY	GG
GHA	GH
GHANA	GH
GHENT BELGIUM	BE
GIB	GI
GIBRALTAR	GI
GIESSEN GERMANY	DE
GIJZENZELE BELGIUM	BE
GILBERT ISLANDS	KI
GIN	GN
GIPPSLAND NEW ZEALAND	NZ
GISHA BURUNDI	BI
GLP	GP
GMB	GM
GNB	GW
GNOWANGERUP WEST AUSTRALIA	AU
GNQ	GQ
GONTRODE BELGIUM	BE
GOSSELIES BELGIUM	BE
GRANADA	GD
GRANDE-BRETAGNE	GB
GRC	GR
GRD	GD
GREAT BAY ESTUARY	US
GREAT BRITAIN	GB
GREAT BRITIAN	GB
GREAT SALT LAKE UTAH USA	US
GRECIA	GR
GRENADE	GD
GRENADINE ISLANDS	VC
GRENADINES	VC
GRENOBLE FRANCE	FR
GRIFFIN USA	US
GRIGNON FRANCE	FR
GRL	GL
GROENLAND	GL
GROENLANDIA	GL
GRÈCE	GR
GTM	GT
GUADALCANAL	SB
GUADALOUPE	GP
GUADALUPE	GP
GUADELOPE	GP
GUADELOUPE	GP
GUAM	GU
GUANAJUATO MEXICO	MX
GUANGDONG	CN
GUATAMALA	GT
GUATEMALA	GT
GUATÉMALA	GT
GUAYANA FRANCESA	GF
GUERET FRANCE	FR
GUERNESEY	GG
GUERNSEY	GB
GUERNSEY UK	GB
GUF	GF
GUIANA	GY
GUINEA	GN
GUINEA BISSAU	GW
GUINEA ECUATORIAL	GQ
GUINEA-BISSAU	GW
GUINÃE	GN
GUINÃE CONAKRY	GN
GUINÃE CONAKRY RÃG FOUTADJALLON	GN
GUINÃECONAKRY	GN
GUINÉE	GN
GUINÉE ÉQUATORIALE	GQ
GUINÉE-BISSAO	GW
GUINÉE-BISSAU	GW
GUINÉE-ÉQUATORIALE	GQ
GULF OF ALASKA	US
GULF OF PETER THE GREAT SEA OF JAPAN RUSSIA	RU
GULF OF VENEZUELA	VE
GUM	GU
GUMMA JAPAN	JP
GUY	GY
GUYANA	GY
GUYANA BRITISH GUIANA	GY
GUYANE	GF
GUYANE FRANÇAISE	GF
GUÃMÃNÃ FRANCE	FR
GÃTEBORG SWEDEN	SE
GÃTTINGEN GERMANY	DE
GÃVLE SWEDEN	SE
GÉORGIE	GE
GÉORGIE DU SUD	GS
GÉORGIE DU SUD-ET-LES ÎLES SANDWICH DU SUD	GS
HABAY LA NEUVE BELGIUM	BE
HADERSLEV JETLAND DENMARK	DK
HAINAULT BELGIUM	BE
HAITÍ	HT
HALLE BELGIUM	BE
HALMSTAD SWEDEN	SE
HAMME BELGIUM	BE
HAMMEMILLE BELGIUM	BE
HANNMÃNDEN GERMANY	DE
HANNOVER GERMANY	DE
HARDING KWAZULUNATAL SOUTH AFRICA	ZA
HARROGATE UK	GB
HAUT RHIN FRANCE	FR
HAUTRAGE BELGIUM	BE
HAVELOCK NORTH NEW ZEALAND	NZ
HAWAII	US
HAWAII USA	US
HAWAIIAN IDS	US
HAWAIIAN ISL	US
HAWAIIAN ISLANDS	US
HAWAÃ	US
HAWKSWORTH MERE WEST YORKSHIRE UK	GB
HAÃTI	HT
HAÏTI	HT
HEARD IS	HM
HEARD-ET-ÎLES MACDONALD, ÎLE	HM
HEIDELBERG GERMANY	DE
HEILONGJIANG PROVINCE CHINA	CN
HELSINKI FINLAND	FI
HERBAL GARDEN KYOTO JAPAN	JP
HERCEGOVINA	BA
HEREDIA	CR
HERMISILLO SONORA MEXICO	MX
HERZEGOVINA	BA
HERZELE BELGIUM	BE
HEVERLEE BELGIUM	BE
HIATI	HT
HIROO TOKYO JAPAN	JP
HIROSHIMA JAPAN	JP
HIRSHOLM DENMARK	DK
HKG	HK
HMD	HM
HND	HN
HOEGAARDEN BELGIUM	BE
HOEK BELGIUM	BE
HOKKAIDO JAPAN	JP
HOLLAND	NL
HOLSTEIN GERMANY	DE
HOLY SEE	VA
HOLZMINDEN GERMANY	DE
HONAN CHINA	CN
HONDURAS	HN
HONDURUS	HN
HONG KONG	HK
HONG KONG SPECIAL ADMINISTRATIVE REGION OF CHINA	HK
HONGARY	HU
HONGKONG	HK
HONGRIE	HU
HONOLULU HAWAII USA	US
HORTICULTURAL CROPS RESEARCH STATION CASTLE HAYNE NORTH CAROLINA USA	US
HOSOGI HIROSHIMA JAPAN	JP
HOT CREEK HATCHERY BISHOP CALIFORNIA	US
HOUGHTON UK	GB
HOWLANDBAKER ISL	UM
HRV	HR
HTI	HT
HUDDINGE SWEDEN	SE
HUHEHOT MONGOLIA CHINA	MN
HUN	HU
HUNGARIA	HU
HUNGRÍA	HU
HVERAGERTHI ICELAND	IS
IAUSTRIA	AT
IBADAN NIGERIA	NG
ICEL	IS
ID CF	ID
IDAHO USA	US
IDN	ID
IEPER BELGIUM	BE
ILLINOIS USA	US
IMN	IM
INACCESSIBLE ISLAND	SH
INADANOBORITO KAWASAKI KANAGAWA JAPAN	JP
IND	IN
INDE	IN
INDENESIA	ID
INDIA	IN
INDIA CA	IN
INDIAN	IN
INDIANA	US
INDONESIA	ID
INDONESIAN	ID
INDONÉSIE	ID
IOT	IO
IOWA USA	US
IPOH MALAYSIA	MY
IRAK	IQ
IRAN	IR
IRAN, RÉPUBLIQUE ISLAMIQUE D'	IR
IRANISLAMICREPUBLICOF	IR
IRAQ	IQ
IREL	IE
IRIAN JAYA	ID
IRISH REPUBLIC	IE
IRL	IE
IRLANDA	IE
IRLANDE	IE
IRN	IR
IRQ	IQ
IRÁN	IR
ISABELA PHILIPPINES	PH
ISL	IS
ISLA BOUVET	BV
ISLA DE MAN	IM
ISLA DE NAVIDAD	CX
ISLAMIC REPUBLIC OF IRAN	IR
ISLAND	IS
ISLANDE	IS
ISLANDIA	IS
ISLAS CAIMÁN	KY
ISLAS COCOS	CC
ISLAS COOK	CK
ISLAS FEROE	FO
ISLAS GEORGIAS DEL SUR	GS
ISLAS HEARDY MCDONALD	HM
ISLAS MALVINAS	FK
ISLAS MARIANAS DEL NORTE	MP
ISLAS MARSHALL	MH
ISLAS PITCAIRN	PN
ISLAS SALOMÓN	SB
ISLAS TURCAS Y CAICOS	TC
ISLAS ULTRAMARINAS DE ESTADOS	UM
ISLAS VÍRGENES BRITÁNICAS	VG
ISLAS VÍRGENES ESTADOUNIDENSES	VI
ISLE OF MAN	GB
ISLE OF MULL SCOTLAND UK	GB
ISOLATED AT TORRY RESEARCH STATION CAUGHT OFF THE NORTH CAPE OF NORWAY	NO
ISR	IL
ISRAEL	IL
ISRAÃL	IL
ISRAËL	IL
ISREAL	IL
ITA	IT
ITALIA	IT
ITALIE	IT
ITHACA USA	US
ITURI LES BAHEMA ZAÃRE	CD
ITURI ZAÃRE	CD
IVORY COAST	CI
IVORY COST	CI
IWATA JAPAN	JP
JAKARTA INDONESIA	ID
JAM	JM
JAMAICA	JM
JAMAÏQUE	JM
JAMCAICA	JM
JAMIACA	JM
JANIOLLE BELGIUM	BE
JAP	JP
JAPANR P CHINA	CN
JAPON	JP
JAPÓN	JP
JAVA	ID
JAVA INDONESIA	ID
JAWA	ID
JERSEY	JE
JERUSALEM ISRAEL	IL
JETTE BELGIUM	BE
JEY	JE
JOHNSTON I	US
JOR	JO
JORDANIA	JO
JORDANIE	JO
JORDON	JO
JPN	JP
JUAN DE FUCA STRAIT	CA
JUAN FERNANDEZ ISL	CL
JUAN FERNÏNDEZ	CL
JÃNKÃPING SWEDEN	SE
KALIMANTAN	MY
KALMAR SWEDEN	SE
KAMERUN	CM
KANAGAWA JAPAN	JP
KANAKAKAI HAWAII USA	US
KANARISCHE EILANDEN	ES
KANSAS	US
KANSAS USA	US
KAOLACK SENEGAL	SN
KAPUNDA AUSTRALIA	AU
KAPUNDA AUTRALIA	AU
KAPUNDA NEAR ADELAIDE AUSTRALIA	AU
KARLSKRONA SWEDEN	SE
KARLSRUHE GERMANY	DE
KARLSTAD SWEDEN	SE
KASACHSSR	KZ
KASUMI DISTRICT NUMAZU JAPAN	JP
KATANNING WEST AUSTRALIA	AU
KATASE JAPAN	JP
KAYES MALI	ML
KAZ	KZ
KAZAJISTÁN	KZ
KAZAKHISTAN	KZ
KAZAKHSTAN	KZ
KAZAKSTAN	KZ
KEN	KE
KENIA	KE
KENT UK	GB
KENTUCKY	US
KENTUCKY USA	US
KENYA	KE
KENYA BUSH DES COLLINES	KE
KENYA CHAMU	KE
KENYA CIKUYU MARAGOLI	KE
KENYA EMBU	KE
KENYA EMBU GIKUYU KIPSIGIS	KE
KENYA EMBU GIKUYU KISIGIS	KE
KENYA EMBU GIKUYU KISIGIS MERU SAMBURU	KE
KENYA EMBU SAMBURU TURKANA KAMBA GIKUYU	KE
KENYA GABBRA	KE
KENYA GIKUYU MERU	KE
KENYA KAMBA	KE
KENYA KIPSIGIS	KE
KENYA KIPSIGIS KAMBA EMBU KIPSIGIS	KE
KENYA LUO	KE
KENYA LUO EMBU GIKUYU KAMBA KIPSIGIS MASAI	KE
KENYA LUO EMBU KIPSIGIS	KE
KENYA MARAGOLI	KE
KENYA MASAI	KE
KENYA MASAÃ amp KIPSIGIS	KE
KENYA POKOT	KE
KENYA PRAIRIE ET BUSH	KE
KENYA RECETTE PROVENANT DEGYPTE	KE
KENYA RÃGION DU NORD	KE
KENYA SAMBURU	KE
KENYA SAMBURU TURKANA	KE
KENYA SOMALI	KE
KENYA TURKANA	KE
KERGUELEN	TF
KERGUELEN IS	TF
KERMADEC IS	NZ
KGZ	KG
KHARTOUM SUDAN	SD
KHM	KH
KIEL FJORD BALTIC SEA	DE
KIESSEE GÃTTINGEN GERMANY	DE
KIJAKA ZAIRE	CD
KINANIRA BURUNDI	BI
KING GEORGE ISLAND SOUTH SHETLAND ISLANDS ANTARCTICA	AQ
KINGDOM OF SPAIN	ES
KINSHASA ZAIRE	CD
KIR	KI
KIRG	KG
KIRGHIZIE	KG
KIRGHIZISTAN	KG
KIRGHIZSTAN	KG
KIRGIZIYA	KG
KIRGSSR	KG
KIRGUISTÁN	KG
KIRGYZIYA	KG
KIRIBATI	KI
KIRIBATI LINE ISL	KI
KIRIBATI REPUBLIC	KI
KISO DISTRICT NAGANO PREF JAPAN	JP
KIVU BUSHI ZAÃRE RÃPUBLIQUE DÃMOCRATIQUE DU CONGO	CD
KLUANG MALAYSIA	MY
KNA	KN
KNOKKE BELGIUM	BE
KOFU JAPAN	JP
KOGONI NIONO MALI	ML
KONGO	CG
KONGO DU ZAÃRE RÃP DÃMOCRATIQUE DU CONGO	CD
KOR	KR
KOREA D P RP	KP
KOREA REP	KR
KOREA SOUTH	KR
KOREAREPUBLIC OF	KR
KOREAREPUBLICOF	KR
KOREASOUTH	KR
KORNIK	PL
KOSRAE	FM
KOSTI SUDAN	SD
KOTZEBUE SOUND	US
KOWEÏT	KW
KREFELD GERMANY	DE
KRITI	GR
KUANTAN MALAYSIA	MY
KULA HAWAII USA	US
KURIL IS	RU
KURIL ISLANDS SEA OF OKHOTSK	RU
KURILE ISLANDS	RU
KURURI CHIBA PREFECTURE JAPAN	JP
KUWAIT	KW
KWATRECHT BELGIUM	BE
KWT	KW
KYOTO JAPAN	JP
L'EX-RÉPUBLIQUE YOUGOSLAVE DE MACÉDOINE	MK
LA GRANJA EXPT STATION NEGRON OCCIDENTAL PHILIPPINES	PH
LA JOLLA CALIFORNIA USA	US
LA MARTINIQUE	MQ
LA ROCHELLE FRANCE	FR
LAGOS	NG
LAJAS VALLEY PUERTO RICO	PR
LAKE CHIEMSEE BAVARIA GERMANY	DE
LAKE IJSSELMEER THE NETHERLANDS	NL
LAKE MENDOTA MADISON USA	US
LAKE OF VENERE AT PANTELLERIA ISLAND SOUTH OF SICILY ITALY	IT
LAKE SILBERSEE NÃRNBERG GERMANY	DE
LAKE SODON	US
LALIBELIA ETHIOPIA	ET
LAMIA GREECE	GR
LANGKLOOF EASTERN CAPE SOUTH AFRICA	ZA
LAO	LA
LAO, RÉPUBLIQUE DÉMOCRATIQUE POPULAIRE	LA
LAOS	LA
LBN	LB
LBR	LR
LBY	LY
LCA	LC
LEADBURGHATCHERY OREGON USA	US
LEEDS UK	GB
LEGON	GH
LEICESTER ENGLAND	GB
LEICESTER ENGLAND UK	GB
LEICESTER UK	GB
LEIDEN THE NETHERLANDS	NL
LEIPZIG GERMANY	DE
LEMBERGE BELGIUM	BE
LEOPOLDSDORF AUSTRIA	AT
LES SAINTES	GP
LESOTHO	LS
LESOTO	LS
LESSER ANTARTICA	AQ
LESSER SUNDA ISL	ID
LESSINES BELGIUM	BE
LETONIA	LV
LETTONIE	LV
LEUSDEN THE NETHERLANDS	NL
LEUVEN BELGIUM	BE
LIAONING	CN
LIAONING PROVINCE CHINA	CN
LIBAN	LB
LIBANON	LB
LIBERIA	LR
LIBIA	LY
LIBYA	LY
LIBYANARABJAMAHIRIYA	LY
LIBYE	LY
LIBÉRIA	LR
LIE	LI
LIECHTENSTEIN	LI
LIKASISUD CONGO	CD
LIMON COSTA RICA	CR
LIMOUSIN FRANCE	FR
LINCOLN NEBRASKA USA	US
LINDHORST HANNOVER GERMANY	DE
LINE ISLANDS	KI
LITTLE CARPATHIANS	SK
LITUANIA	LT
LITUANIE	LT
LIVINGSTON ISLAND SOUTH SHETLAND ISLANDS ANTARCTICA	AQ
LIVNO YUGOSLAVIA	BA
LJUBLJANA SLOVENIA	SI
LKA	LK
LOCKYER VALLEY QUEENSLAND AUSTRALIA	AU
LOGAN UTAH USA	US
LOMMEL BELGIUM	BE
LONDERZEEL BELGIUM	BE
LONDON ENGLAND	GB
LONDON ONTARIO CANADA	CA
LONDON UK	GB
LONG ISLAND USA	US
LOPEZ BOHOL PHILIPPINES	PH
LORD HOWE I	AU
LORD HOWE ISL	AU
LORD HOWE ISLAND	AU
LOS ANGELES USA	US
LOS BANOS LAGUNA PHILIPPINES	PH
LOT FRANCE	FR
LOUISIANA	US
LOUISIANA USA	US
LOWER HUTT NEW ZEALAND	NZ
LSO	LS
LTU	LT
LUCTUGAN ROXAS CITY PHILIPPINES	PH
LUDHIANA INDIA	IN
LUND SWEDEN	SE
LUO DU SIAYA KENYA	KE
LUX	LU
LUXEMBOURG	LU
LUXEMBURG	LU
LUXEMBURGO	LU
LVA	LV
LYON FRANCE	FR
LÃNKÃPING SWEDEN	SE
LÍBANO	LB
MAASLAND THE NETHERLANDS	NL
MAC	MO
MACAO	MO
MACAO SPECIAL ADMINISTRATIVE REGION OF CHINA	MO
MACAU	CN
MACDONALD COLLEGE QUEBEC CANADA	CA
MACEDONIA	MK
MACQUARIE IS	AQ
MACQUARIE ISL	AQ
MACQUARIE ISLAND ANTARCTICA	AQ
MACÉDOINE	MK
MACÉDOINE, L'EX-RÉPUBLIQUE YOUGOSLAVE DE	MK
MADAGASCAR	MG
MADAGASCAR HAUTSPLATEAUX	MG
MADAGASCAR TANANARIVE	MG
MADEIRA	PT
MADEIRA IS	PT
MADEIRAS	PT
MADGASCAR	MG
MADIERA	PT
MADRID AREA SPAIN	ES
MADRID SPAIN	ES
MAFFLE BELGIUM	BE
MAINE	US
MAJORCA	ES
MAKATKATUIT GUIMBA NUEVA ECIJA PHILIPPINES	PH
MAKE	MK
MALABAR COAST	IN
MALACCA MALAYSIA	MY
MALAGASY REPUBLIC	MG
MALAISIE	MY
MALAITA	SB
MALASIA	MY
MALAUI	MW
MALAWI	MW
MALAWINYASALAND	MW
MALAY PENINSULA	MY
MALAYA	MY
MALAYA MALAYSIA	MY
MALAYASIA	MY
MALAYSIA WEST	MY
MALDEGEM BELGIUM	BE
MALDIVAS	MV
MALDIVE ISLANDS	MV
MALDIVES	MV
MALESIA	MY
MALI	ML
MALI RÃGIONS SIKASSO BOUGOUNI	ML
MALINAO NARRA PALAWAN PHILIPPINES	PH
MALLORCA SPAIN	ES
MALMÃ SWEDEN	SE
MALORCA	ES
MALTA	MT
MALTE	MT
MALUKU	ID
MALÍ	ML
MANCHESTER UK	GB
MANCHURIA	CN
MANDAPAM INDIA	IN
MANILA PHILIPPINES	PH
MANITOBA CANADA	CA
MANOORA SOUTH AUSTRALIA	AU
MAR	MA
MARIANA ISLANDS	MP
MARIANAS ISLANDS	US
MARIANNE ISLANDS	MP
MARIANNES DU NORD, ÎLES	MP
MARIEGALANTE	GP
MARKE BELGIUM	BE
MAROC	MA
MAROUA CAMEROON	CM
MARQUESAS	PF
MARQUESAS IS	PF
MARQUESAS IS FR	PF
MARRUECOS	MA
MARSEILLE FRANCE	FR
MARSHALL	MH
MARSHALL IDS	MH
MARSHALL IS	MH
MARSHALL ISL	MH
MARSHALL, ÎLES	MH
MARTIN HOUSE NORTHWEST TERRITORIES CANADA	CA
MARTINICA	MQ
MARTINIQUE	MQ
MARTINIQUE FRENCH WEST INDIES	MQ
MARYLAND USA	US
MASCARENE ISLANDS	MU
MASSACHUSETTS	US
MASSACHUSETTS GEORGIA USA	US
MASSACHUSETTS USA	US
MAUI HAWAII USA	US
MAURETANIA	MR
MAURICE	MU
MAURICIO	MU
MAURITANIA	MR
MAURITANIE	MR
MAURITANIE RÃGION DE CHINGETTI	MR
MAURITIUS ISLAND	MU
MAYOTTE	YT
MCO	MC
MDA	MD
MDG	MG
MDV	MV
MEDITERRANEAN SEA ISRAEL	IL
MEIDERA	PT
MEIDERA ARCHIPEL	PT
MELBOURNE AUSTRALIA	AU
MELLE BELGIUM	BE
MENAI STRAIT UK	GB
MENTEKAB MALAYA	MY
MERELBEKE BELGIUM	BE
MES MIDSAYAP NORTH COTABATO PHILIPPINES	PH
MESLIN LEVÃªQUE BELGIUM	BE
MEX	MX
MEXICO SOUTHEAST	MX
MEXIQUE	MX
MHL	MH
MICHIGAN USA	US
MICRONESIA	FM
MICRONESIA FEDERATED STATES	FM
MICRONESIA FS	FM
MICRONESIAFS	FM
MICRONÉSIE	FM
MICRONÉSIE, ÉTATS FÉDÉRÉS DE	FM
MIDDENFRANKRIJK	FR
MIDSAYAG NORTH CATABATO PHILIPPINES	PH
MIDWAY IS	UM
MIGAYI PREFECTURE JAPAN	JP
MILFORD CONNECTICUT USA	US
MINDEN GERMANY	DE
MINNEAPOLIS USA	US
MINNESOTA USA	US
MINTER CREEK FISH HATCHERY WASHINGTON STATE USA	US
MISSISSIPI RIVER USA	US
MISSOURI USA	US
MITAKA TOKYO JAPAN	JP
MIYAGI PREFECTURE JAPAN	JP
MKD	MK
MLI	ML
MLT	MT
MMR	MM
MNE	ME
MNG	MN
MNP	MP
MOBARA CHIBA PREF JAPAN	JP
MOBAYI ZAIRE	CD
MOCAMBIQUE	MZ
MOERBEKE BELGIUM	BE
MOJAVE DESERT ROSAMOND CALIFORNIA USA	US
MOLDAVIA	MD
MOLDAVIE	MD
MOLDOVA	MD
MOLDOVA REP	MD
MOLDOVA, RÉPUBLIQUE DE	MD
MOLOKAI HAWAII USA	US
MOLRAUW BELGIUM	BE
MOLUCCAS	ID
MONACO	MC
MONAUBERT FRANCE	FR
MONGOLIA	MN
MONGOLIE	MN
MONSERRAT	MS
MONTANA USA	US
MONTENEGRO	ME
MONTEREY COUNTY CALIFORNIA USA	US
MONTREUIL FRANCE	FR
MONTSERRAT	MS
MONTST GUIBERT	BE
MONTÉNÉGRO	ME
MOOREA	PF
MOOS GERMANY	DE
MORROCCO	MA
MOSCOW RUSSIA	RU
MOSCWA RIVER FORMER USSR	RU
MOSSAMBIQUE	MZ
MOUNT RITTMANN ANTARCTICA	AQ
MOZ	MZ
MOZAMBIQUE	MZ
MOZAMBIQUE MAPUTO	MZ
MRT	MR
MSR	MS
MTQ	MQ
MUNANIRA BURUNDI	BI
MUNICH GERMANY	DE
MURRAY BRIDGE SOUTH AUSTRALIA	AU
MUS	MU
MUSEO CORRER VENICE ITALY	IT
MWI	MW
MYANMAR	MM
MYANMAR BURMA	MM
MYS	MY
MYT	YT
MÃLMO SWEDEN	SE
MÃLNDAL SWEDEN	SE
MÃNCHEN GERMANY	DE
MÉXICO	MX
MÓNACO	MC
N AUSTRALIA	AU
N KOREA	KP
N MARIANAS	US
NAGANO PREFECTURE JAPAN	JP
NAGOYA JAPAN	JP
NAIROBI	KE
NAIROBI KENYA	KE
NAM	NA
NAMAIBIA	NA
NAMBIA	NA
NAMIBIA	NA
NAMIBIA SWA	NA
NAMIBIE	NA
NANCY	FR
NANJING CHINA	CN
NARBONNE FRANCE	FR
NASHVILLE USA	US
NAURA ISLAND PACIFIC OCEAN JAPAN	JP
NAURU	NR
NAURU ISLAND	NR
NAVASSA	US
NAVASSA ID	UM
NAVASSA ISLAND	UM
NCL	NC
NDERLAND	NL
NE BOSNIAHERZEGOVINA	BA
NEAR ALICANTE SPAIN	ES
NEAR HALE CENTER TEXAS USA	US
NEAR HILDENBOROUGH KENT UK	GB
NEAR HUDSON NEW YORK USA	US
NEAR LAKE LERMA MEXICO	MX
NEAR LAKE TAUPO NEW ZEALAND	NZ
NEAR NEUCHÃTEL SWITZERLAND	CH
NEAR NICE FRANCE	FR
NEAR NORDMALUNG SWEDEN	SE
NEAR RIVER NISCHENKA MOSCOW REGION FORMER USSR	RU
NEAR SYRACUSE NEW YORK USA	US
NEAR TOKYO JAPAN	JP
NEAR ZOTTEGEM BELGIUM	BE
NEBRASKA	US
NEBRASKA USA	US
NEDERALND	NL
NEDERBOELARE BELGIUM	BE
NEEROETEREN BELGIUM	BE
NEPAL	NP
NER	NE
NERITIC ZONE NEAR NICE FRANCE	FR
NETHANTILLES	AN
NETHEN BELGIUM	BE
NETHERLAND	NL
NETHERLAND ANTILLES	AN
NETHERLANDS	NL
NETHERLANDS ANTILLES	AN
NETTET BELGIUM	BE
NEUMARKT GERMANY	DE
NEVADA	US
NEVIS	KN
NEVIS ISLAND	KN
NEW BRITAIN	PG
NEW FOUNDLAND	CA
NEW HAMPSHIRE USA	US
NEW HAVEN USA	US
NEW HEBRIDES	VU
NEW HIBRIDES	VU
NEW IRELAND	PG
NEW JERSEY	US
NEW JERSEY USA	US
NEW MEXICO	US
NEW MEXICO USA	US
NEW SOUTH WALES	AU
NEW SOUTH WALES AUSTRALIA	AU
NEW SOUTH WALES SYDNEY AUSTRALIA	AU
NEW YORK USA	US
NEW ZEALAND	NZ
NEW ZEALAND AOTEAROA	NZ
NEW ZEALNAD	NZ
NEWCALEDONIA	NC
NEWCASTLE UK	GB
NEWCASTLEUPONTYNE ENGLAND	GB
NEWFOUNDLAND	CA
NEWZEALAND	NZ
NFK	NF
NGA	NG
NHATRAND VIETNAM	VN
NHEBRIDEN	VU
NIC	NI
NICARAGUA	NI
NICE FRANCE	FR
NICOBAR ISLANDS	IN
NIGER	NE
NIGERDOSSO	NE
NIGERHAUSA	NE
NIGERI	NG
NIGERIA	NG
NIGERIA FULANI	NG
NIGERIA NORD	NG
NIGERIA SUD	NG
NIGHTINGALE ISLAND	SH
NIGÃRIA	NG
NIGÉRIA	NG
NISHINOMIYA JAPAN	JP
NIU	NU
NIUE	NU
NIUÉ	NU
NL CF	NL
NLD	NL
NOCAKIRO IVORY COAST	CI
NOR	NO
NORD CTE IV LATAHA AFR OUEST	CI
NORD CTIV	CI
NORDKIVU ZAÃRE RÃPUBLIQUE DÃMOCRATIQUE DU CONGO	CD
NORFOLK	GB
NORFOLK I	NF
NORFOLK ISL	NF
NORFOLK, ÎLE	NF
NORFOLKISLAND	NF
NORMANDY FRANCE	FR
NORSE BEACH PUERTO PEÃASCO SONORA MEXICO	MX
NORTH AMERICA	US
NORTH AUSTRALIA	AU
NORTH CAROLINA	US
NORTH CAROLINA USA	US
NORTH DAKOTA USA	US
NORTH GERMAN NORTH SEA COAST GERMANY	DE
NORTH INDIA	IN
NORTH KAOLACK SENEGAL	SN
NORTH KOREA	KP
NORTH PERZIÃ	IR
NORTH SEA ABERDEEN UK	GB
NORTH VIETNAM	VN
NORTH WALES	GB
NORTHBRAZILIA	BR
NORTHERN BULGARIA	BG
NORTHERN IRELAND	GB
NORTHERN LINE ISLANDS	KI
NORTHERN MARIANA ISLANDS	US
NORTHERN MARIANAS	US
NORTHERN VIRGINIA USA	US
NORUEGA	NO
NORVÈGE	NO
NORW	NO
NORWAY	NO
NORWICH UK	GB
NOTTINGHAM UK	GB
NOUVELLE-CALÉDONIE	NC
NOUVELLE-GUINÉE	PG
NOUVELLE-ZÉLANDE	NZ
NOUZILLY FRANCE	FR
NOVA SCOTI HALIFAX CANADA	CA
NOVA SCOTIA CANADA	CA
NPL	NP
NRU	NR
NUEVA CALEDONIA	NC
NUEVA ECIJA PHILIPPINES	PH
NUEVA ZELANDA	NZ
NWECUADOR	EC
NYASALAND	MW
NYASALAND MALAWI	MW
NYMPH CREEK YELLOWSTONE NATIONAL PARK USA	US
NZL	NZ
NÃRNBERG GERMANY	DE
NÉPAL	NP
NÍGER	NE
OAHU HAWAII USA	US
OCCUPIED PALESTINIAN TERRITORY	PS
OCÉAN INDIEN, TERRITOIRE BRITANNIQUE DE L'	IO
ODENSE DENMARK	DK
OEDELEM BELGIUM	BE
OELEGEM BELGIUM	BE
OFF CAPE TOWN SOUTH AFRICA	ZA
OFF COAST OAHU HAWAII USA	US
OFF COAST OF HAWAII USA	US
OFF COAST OF OAHU HAWAII USA	US
OFF NORTH CAPE NORWAY	NO
OFF THE COAST OF KANAGAWA PREFECTURE JAPAN	JP
OFF THE COAST OF NICE FRANCE	FR
OFF THE COAST OF NORTHERN CALIFORNIA USA	US
OFF THE IMMEDIATE COAST OF OAHU HAWAII USA	US
OGASAWARA IS	JP
OHIO	US
OHIO USA	US
OISE FRANCE	FR
OKAIA NEW ZEALAND	NZ
OKINAWA JAPAN	JP
OKLAHOMA USA	US
OLD NORW	NO
OLLIGNIES BELGIUM	BE
OMAN	OM
OMN	OM
OMÁN	OM
ONEIDA LAKE NEW YORK USA	US
ONTARIO CANADA	CA
ONTARIO TORONTO CANADA	CA
OOSTERZELE BELGIUM	BE
OPER VOLTA	BF
OREBRO SWEDEN	SE
OREGON USA	US
ORINDA CALIFORNIA USA	US
ORINOCO RIVER REGION VENEZUELA	VE
ORLY FRANCE	FR
ORLÃANS FRANCE	FR
ORNE ESTUARY NORMANDY FRANCE	FR
OSAKA JAPAN	JP
OSLO NORWAY	NO
OSS THE NETHERLANDS	NL
OSSEMEERSEN GHENT BELGIUM	BE
OSWEGO COUNTY NEW YORK USA	US
OTAGO NEW ZEALAND	NZ
OTTAWA CANADA	CA
OUGANDA	UG
OUGANDA RÃGION DU PARC DE BWINDI	UG
OUZBÉKISTAN	UZ
OVERPELT BELGIUM	BE
P R CHINA	CN
P R CONGO	CD
PAASEILAND	CL
PAC IS TR TR	UM
PAIWA TABACO ALBAY PHILIPPINES	PH
PAK	PK
PAKISTAN	PK
PAKISTÁN	PK
PALAOS	PW
PALAU	PW
PALAU IDS	PW
PALAWAN PHILIPPINES	PH
PALESTINE	PS
PALESTINIEN OCCUPÉ, TERRITOIRE	PS
PAMAMA	MA
PAMEL BELGIUM	BE
PAN	PA
PANABO DAVAO PHILIPPINES	PH
PANAMA	PA
PANAMÁ	PA
PANANMA	PA
PANGIL LAGUNA PHILIPPINES	PH
PAPAU NEW GUINEA	PG
PAPAUA NEW GUINEA	PG
PAPOUASIE	PG
PAPOUASIE-NOUVELLE-GUINÉE	PG
PAPUA	PG
PAPUA N GUIN	PG
PAPUA NEW GUIENA	PG
PAPUA NEW GUIN	PG
PAPUA NEW GUINEA	PG
PAPUA NEW GUINEA POSSIBLY	PG
PAPUANEW GUINEA	PG
PAPUANEWGUINEA	PG
PAPÚA NUEVA GUINEA	PG
PAQAPUA NEW GUINEA	PG
PARAGUAY	PY
PARANA STATE BRAZIL	BR
PARAQUANA	VE
PASKOV CZECH REPUBLIC	CZ
PASSAU GERMANY	DE
PAULINENAUE BRANDENBURG GERMANY	DE
PAWA MALINAW ALBAY PHILIPPINES	PH
PAYS-BAS	NL
PAÍSES BAJOS	NL
PCN	PN
PENINSULA TIHANY HUNGARY	HU
PENINSULAR MALAYSIA	MY
PENINSULAR MALYSIA	MY
PENNSYLVANIA	US
PENNSYLVANIA STATE UNIVERSITY USA	US
PENNSYLVANIA USA	US
PEOPLES REPUBLIC OF CHINA	CN
PER	PE
PERNAMBUCO BRAZIL	BR
PERTH AUSTRALIA	AU
PERTH WESTERN AUSTRALIA	AU
PERU	PE
PERÚ	PE
PETIT ENGHIEN BELGIUM	BE
PHILIIPPINES	PH
PHILIPIJNEN	PH
PHILIPINES	PH
PHILIPPINE	PH
PHILIPPINE IDS	PH
PHILIPPINE ISLANDS	PH
PHILIPPINES	PH
PHILLIPINE IDS	PH
PHILLIPINE ISLANDS	PH
PHILLIPINES	PH
PHILLIPPINES	PH
PHILPPINES	PH
PHL	PH
PHOENIX GROUP	KI
PHOENIX ISLANDS	KI
PIET RETIEF MPUMALANGA SOUTH AFRICA	ZA
PIETERMARITZBURG KWAZULUNATAL SOUTH AFRICA	ZA
PINGTUNG TAIWAN	TW
PISANG ISLAND	IN
PITCAIRN	PN
PITCAIRN ISL	PN
PITCAIRN ISLAND	PN
PITCAIRN ISLANDS	PN
PITTEM BELGIUM	BE
PLANTS OF CHINA	CN
PLANTS OF USA	US
PLATTE RIVER FISH HATCHERY MICHIGAN USA	US
PLILIPPIJNEN	PH
PLUMCHIAU FRANCE	FR
PLUSSEE HOLSTEIN	DE
PLW	PW
PNG	PG
POHNPEI	FM
POL	PL
POLANGUI ALBAY PHILIPPINES	PH
POLINESIA FRANCESA	PF
POLINYA DEL JUCAR VALENCIA SPAIN	ES
POLLARE BELGIUM	BE
POLOGNE	PL
POLONIA	PL
POLYNESIÃ	PF
POLYNÉSIE FRANÇAISE	PF
PONT LEVÃQUE NORMANDY FRANCE	FR
PORT CRISTO MALLORCA SPAIN	ES
PORT HUENEME USA	US
PORT ORCHARD WASHINGTON USA	US
PORTANGOLA	AO
PORTO RICO	PR
PORTUGAL	PT
PORVOO FINLAND	FI
POSSIBLY FED ST OF MICRONESIA	FM
POSSIBLY NEW ZEALAND	NZ
POSSIBLY PALAU	PW
POTOMAC RIVER USA	US
POTTES BELGIUM	BE
POTUGAL	PT
PRESTON UK	GB
PRESUMED AUSTRALIA	AU
PRESUMED ECUADOR	EC
PRESUMED LAOS	LA
PRESUMED NEPAL	NP
PRESUMED NEW GUINEA	ID
PRESUMED PAPUA NEW GUINEA	PG
PRESUMED TERR NEW GUINEA	PN
PRESUMED TONGA	TO
PRESUMED USA	US
PRESUMED VIETNAM	VN
PRETORIA SOUTH AFRICA	ZA
PRI	PR
PRINCE EDWARD IS	CA
PRK	KP
PROBABLY CHINA	CN
PROBABLY ISOLATED IN NORWAY	NO
PROBABLY THAILAND	TH
PROBABLY USA	US
PRT	PT
PRY	PY
PSE	PS
PT GAWLER SOUTH AUSTRALIA	AU
PUERTO	PR
PUERTO RICO	PR
PUERTORICO	PR
PUNJAB PAKISTAN	PK
PUSAKANEGARA WJAVA INDONESIA	ID
PYF	PF
PYRENÃES ORIENTALES FRANCE	FR
PÉROU	PE
QAT	QA
QATAR	QA
QUADELOUPE	GP
QUEBEC	CA
QUEBEC CANADA	CA
QUEEN CHARLOTTE SOUND	NZ
QUEENSLAND	AU
QUEENSLAND AUSTRALIA	AU
RAMONVILLESAINTAGNE HAUTEGARONNE FRANCE	FR
RAMSKAPELLE BELGIUM	BE
RDC	CD
RECIFE BRAZIL	BR
REINO UNIDO	GB
REP MALAGASIA	MG
REP SOUTH AFRICA	ZA
REPUBLIC OF CONGO	CD
REPUBLIC OF CROATIA	HR
REPUBLIC OF GEORGIA	GE
REPUBLIC OF HONDURAS	HN
REPUBLIC OF KENYA	KE
REPUBLIC OF KOREA	KR
REPUBLIC OF MACEDONIA	MK
REPUBLIC OF MOLDOVA	MD
REPUBLIC OF PALAU	PW
REPUBLIC OF PANAMA  PA
REPUBLIC OF SEYCHELLES	SC
REPUBLIC OF SIERRA LEONE	SL
REPUBLIC OF SOUTH AFRICA	ZA
REPUBLIC OF THE MARSHALL ISLANDS	MH
REPUBLIC OF THE PHILIPPINES	PH
REPUBLICA DOMINICA	DO
REPUBLICA DOMINICANA	DO
REPÚBLICA CENTROAFRICANA	CF
REPÚBLICA CHECA	CZ
REPÚBLICA DE MACEDONIA	MK
REPÚBLICA DEL CONGO	CG
REPÚBLICA DEMOCRÁTICA DEL CONGO	CD
REPÚBLICA DOMINICANA	DO
REPÚBLICA ÁRABE SAHARAUI	EH
RESURRECTION BAY NEAR SEWARD ALASKA	US
RETIE BELGIUM	BE
REU	RE
REUNION	RE
REUNION ISLAND	RE
REUNIÓN	RE
REVILLAGIGEDO	MX
RHODE ISLAND	US
RHODE ISLAND USA	US
RHODESIA	ZW
RHODOS GREECE	GR
RIJKEVORSEL BELGIUM	BE
RILLAAR BELGIUM	BE
RINGVASSÃY NORWAY	NO
RIO DE JANEIRO BRAZIL	BR
RIRRILET COSTA RICA	CR
RIUKIU ISLANDS	JP
RIVER AVON HAMPSHIRE ENGLAND	GB
RIVER CLETTER UK	GB
RIVER ELBE	DE
RIVER MOSCOW RUSSIA	RU
RIVER MOSCWA FORMER USSR	RU
RIVER PLYM DARTMOOR	GB
RIVER SPEY ABERLOUR SCOTLAND	GB
RIVER WEENDE GÃTTINGEN GERMANY	DE
RIVER WESER GERMANY	DE
RIVER WEY GUILFORD SURREY UK	GB
RIVER YVETTE FRANCE	FR
ROCKDALE UK	GB
RODESIA	ZW
RODRIGUES ISLAND	MU
RODRIGUEZ	MU
RODRIQUES	MU
ROEMENIE	RO
ROEMENIÃ	RO
ROMANIA	RO
ROODEPLAAT PRETORIA SOUTH AFRICA	ZA
ROOSDAAL BELGIUM	BE
ROTHAMSTED UK	GB
ROTORUA NEW ZEALAND	NZ
ROU	RO
ROUMANIA	RO
ROUMANIA ROMANIA	RO
ROUMANIAROMANIA	RO
ROUMANIE	RO
ROUVEROY BELGIUM	BE
ROYAL RESEARCH STATION OF GORSEM SINTTRUIDEN BELGIUM	BE
ROYAUME-UNI	GB
RUANDA	RW
RUDDERVOORDE BELGIUM	BE
RUFISQUE NEAR DAKAR SENEGAL	SN
RUMANIA	RO
RUS	RU
RUSIA	RU
RUSLAND	RU
RUSSIA	RU
RUSSIA CIS FORMER USSR	RU
RUSSIAN FED	RU
RUSSIE	RU
RUSSIE, FÉDÉRATION DE	RU
RUTEGAMA BURUNDI	BI
RWA	RW
RWANDA	RW
RWANDA NORD	RW
RWANDA PRÃFECTURE DE GISENYI	RW
RYSTRÃMMEN NORWAY	NO
RYUKYU IS	JP
RYUKYU TRENCH	JP
RÃDESHEIM GERMANY	DE
RÃPUBLIQUE CENTRAFRICAINE	CF
RÃPUBLIQUE CENTRAFRICAINE OUBANGUI	CF
RÃPUBLIQUE CENTRAFRICAINE RÃPUBLIQUE DU CONGOBRAZZAVILLE	CF
RÃPUBLIQUE DE GUINÃE	GN
RÃPUBLIQUE POPULAIRE DU CONGO	CG
RÃPUBLIQUE POPULAIRE DU CONGO AUTOUR DU VILLAGE DE MOUMPOUTOU LE LONG DE LA RIVIÃRE	CG
RÃPUBLIQUE POPULAIRE DU CONGO AUTOUR DUVILLAGE DE MOUMPOUTOU LE LONG DE LA RIVIÃRE	CG
RÃUNION	RE
RÉPUBLIQUE ARABE SYRIENNE	SY
RÉPUBLIQUE BOLIVARIENNE DU VENEZUELA	VE
RÉPUBLIQUE CENTRAFRICAINE	CF
RÉPUBLIQUE DE CORÉE	KR
RÉPUBLIQUE DE MOLDOVA	MD
RÉPUBLIQUE DOMINICAINE	DO
RÉPUBLIQUE DÉMOCRATIQUE DU CONGO	CD
RÉPUBLIQUE DÉMOCRATIQUE POPULAIRE LAO	LA
RÉPUBLIQUE ISLAMIQUE D'IRAN	IR
RÉPUBLIQUE POPULAIRE DÉMOCRATIQUE DE CORÉE	KP
RÉPUBLIQUE TCHÈQUE	CZ
RÉPUBLIQUE-UNIE DE TANZANIE	TZ
RÉUNION	RE
RÏUNION	RE
S AFRICA	ZA
S AUSTRALIA	AU
S KOREA	KR
S OF GERMANY	DE
S THAILAND	TH
SABAH	MY
SAHARA OCCIDENTAL	EH
SAINT CHRISTOPHER	KN
SAINT CHRISTOPHERNEVIS	KN
SAINT CROIX	US
SAINT HELENA	SH
SAINT KITTSNEVIS	KN
SAINT PIERRE	PM
SAINT THOMAS	VI
SAINT VINCENT	VC
SAINT VINCENT AND THE	VC
SAINT VINCENT amp THE GRENADINES	VC
SAINT VINCENTGRENADINES	VC
SAINT-BARTHÉLEMY	BL
SAINT-CHRISTOPHE-ET-NEVIS	KN
SAINT-CHRISTOPHE-ET-NIÉVÈS	KN
SAINT-EUSTACHE	BQ
SAINT-KITTS-ET-NEVIS	KN
SAINT-MARIN 	SM
SAINT-MARTIN (PARTIE NÉERLANDAISE)	SX
SAINT-MARTIN(PARTIE FRANÇAISE)	MF
SAINT-PIERRE-ET-MIQUELON	PM
SAINT-SIÈGE	VA
SAINT-SIÈGE (ÉTAT DE LA CITÉ DU VATICAN)	VA
SAINT-VINCENT-ET-LES GRENADINES	VC
SAINTE-HÉLÈNE, ASCENSION ET TRISTAN DA CUNHA	SH
SAINTE-LUCIE	LC
SALISBURY ENGLAND	GB
SALOMON	SB
SALOMON ISLANDS	SB
SALOMON, ÎLES	SB
SALTON SEA CALIFORNIA USA	US
SALVADOR	SV
SAMBYU KAVANGO NAMIBIA	NA
SAMOA	WS
SAMOA AMERICAN	AS
SAMOA AMERICANA	AS
SAMOA AMÉRICAINES	AS
SAMOA ISLANDS	WS
SAMUGAWA BEACH JAPAN	JP
SAN CRISTÓBAL Y NIEVES	KN
SAN ENRIQUE NEGROS OCC PHILIPPINES	PH
SAN FABIAN ISABELA PHILIPPINES	PH
SAN FREDERIGO TUSCANY ITALY	IT
SAN JOSE COSTA RICA	CR
SAN MARINO	SM
SAN PEDRO Y MIQUELÓN	PM
SAN VICENTE Y	VC
SANDNESSUNDET NORWAY	NO
SANDWICH ISLAND	GS
SANTA CRUZ ISL	US
SANTA HELENA	SH
SANTA LUCÍA	LC
SANTO DOMINGO	DO
SANTO TOMÉ Y PRÍNCIPE	ST
SAO TOME	ST
SAO TOME PRN	ST
SAO TOMÉ-ET-PRINCIPE	ST
SAOTOMEANDPRINCIPE	ST
SAPELO ISLAND GEORGIA USA	US
SARAWAK	MY
SARDEGNA	IT
SARDINIA	IT
SARDINIA ITALY	IT
SASKATCHEWAN SASKATOON CANADA	CA
SAU	SA
SAUDI ARABIA	SA
SAUDIARABIA	SA
SAUMUR MAINE ET LOIRE FRANCE	FR
SCHOONAARDE BELGIUM	BE
SCOT IREL ENG	GB
SCOTL	GB
SCOTLAND	GB
SCOTLAND UK	GB
SCOTLAND UK ATLANTIC OCEAN	GB
SCOTLAND UK SCOTCH	GB
SCOTLAND WEST COAST	GB
SDN	SD
SE QUEENSLAND AUSTRALIA	AU
SEA OF JAPAN FAR EAST OF RUSSIA	RU
SEATTLE USA	US
SEEBURG GERMANY	DE
SEINE MARITIME FRANCE	FR
SELTA AREA EGYPT	EG
SELVAGENS	PT
SEN	SN
SENEGAL	SN
SENEGAL CASAMANCE	SN
SENSIN BELGIUM	BE
SERBIA	RS
SERBIE	RS
SERDANG MALAYSIA	MY
SETURKEY	TR
SEYCHELLE IDS	SC
SEYCHELLE ISLANDS	SC
SEYCHELLES	SC
SEYCHELLES REPUBLIC	SC
SGP	SG
SGS	GS
SHAANXI NORTHWESTERN CHINA	CN
SHANGHAI CHINA	CN
SHETLAND ISLANDS	GB
SHIMOGAMO KYOTO JAPAN	JP
SHINFIELD UK	GB
SHITURU CONGO	CD
SHIZUOKA PREFECTURE JAPAN	JP
SHN	SH
SHORTLAND IDS	SB
SHOWA STATION ANTARCTICA	AQ
SHRILANKA	LK
SIAM	TH
SIBERIA	RU
SIBERIA RUSSIA	RU
SICILIA	IT
SICILY	IT
SICILY ITALY	IT
SIERRA DE HUAUTLA MEXICO	MX
SIERRA LEONA	SL
SIERRA LEONE	SL
SIERRA LEONE RÃGION DE LA KARINA	SL
SIERRA LEONES	SL
SIERRALEONE	SL
SIERRE LEONE	SL
SINGAPORE MALAYA	SN
SINGAPOUR	SG
SINGAPUR	SG
SIREUIL CHARENTES FRANCE	FR
SIRIA	SY
SIVASH LAKE CRIMEA UKRAINE	UA
SJM	SJ
SKOCJAUSKE JAME	SI
SKOVDE SWEDEN	SE
SKÃVDE SWEDEN	SE
SLAGELSE DENMARK	DK
SLB	SB
SLE	SL
SLOVACIA	SK
SLOVAK REPUBLIC	SK
SLOVAQUIE	SK
SLOVÉNIE	SI
SLV	SV
SMR	SM
SNAKE RIVER WASHINGTON STATE USA	US
SNELLEGEM BELGIUM	BE
SOCIETY ISL	PF
SOCIETY ISLANDS	PF
SOCOTRA	YE
SOEDAN	SD
SOFIA BULGARIA	BG
SOISSONS AISNE FRANCE	FR
SOLOMON ID	SB
SOLOMON IDS	SB
SOLOMON IS	SB
SOLOMON ISL	SB
SOM	SO
SOMALI REPUBLIC	SO
SOMALIA	SO
SOMALIE	SO
SOMEREN THE NETHERLANDS	NL
SORSOGON SORSOGON PHILIPPINES	PH
SOUDAN	SD
SOUDAN DU SUD	SS
SOUDAN EST	SD
SOUDAN ET SOUDAN FULANI	SD
SOUDAN FULANI	SD
SOUDAN KORDOFAN	SD
SOUDAN RÃGION DE LEST	SD
SOUSS MOROCCO	MA
SOUTH AFICA	ZA
SOUTH AFRICA	ZA
SOUTH AFRICAN	ZA
SOUTH AUSTRALIA	AU
SOUTH CAROLINA	US
SOUTH CAROLINA USA	US
SOUTH CHINA SEA CHINA	CN
SOUTH COPENHAGEN DENMARK	DK
SOUTH DAKOTA USA	US
SOUTH EAST OF ABERDEEN MILES EAST	GB
SOUTH ESSEX UK	GB
SOUTH GEORGIA	GS
SOUTH INDIA	IN
SOUTH KAOLACK SENEGAL	SN
SOUTH KOREA	KR
SOUTH NIGERIA	NG
SOUTH ORKNEY IS	AQ
SOUTH SHETLAND	AQ
SOUTH SHETLAND ISLANDS	AQ
SOUTH VIETNAM	VN
SOUTH WEST AFRICA	NA
SOUTH YEMEN	YE
SOUTHAFRICA	ZA
SOUTHCHINA	CN
SOUTHERN BULGARIA	BG
SOUTHERN CHINA	CN
SOUTHERN ENGLAND UK	GB
SOUTHERN RODESIA	ZW
SOUTHERN URAL RUSSIA	RU
SOUTHFRANCE	FR
SOUTHITALY	IT
SPETSBERGEN	SJ
SPIRIT LAKE WASHINGTON USA	US
SPITZBERGEN	SJ
SPM	PM
SR CF	SR
SRB	RS
SRI LANKA	LK
SRI LANKA CEYLON	LK
SRILANKA	LK
SRODESIA	ZW
ST AMANDS BELGIUM	BE
ST BARTHELEMY	GP
ST BARTHELEMY ISLAND	GP
ST BRIEUC FRANCE	FR
ST CHRISTOPHERNEVIS	KN
ST CROIX	US
ST EUSTATIUS	AN
ST EUSTATIUS ISLAND	AN
ST GHISLAINE BELGIUM	BE
ST HELENA	SH
ST KITTS	KN
ST KITTS NEV	KN
ST KITTS amp NEVIS	KN
ST KITTSNEVIS ISLANDS	KN
ST LOUIS USA	US
ST LUCIA	LC
ST LUCIA ISLAND	LC
ST MARTIN ISLAND	GP
ST MAURICE FRANCE	FR
ST NARAIRE FRANCE	FR
ST PAUL IS	TF
ST PIER MQ	MQ
ST PIETERSHOSPITAAL BRUSSEL BELGIUM	BE
ST THOMAS	VI
ST THOMAS HOSPITAL LONDON UK	GB
ST VICENT amp THE GREN	VC
ST VIN amp THE GRENADINES	VC
ST VINCENT	VC
ST VINCENT AND THE GREN	VC
ST VINCENT AND THE GRENADINES	VC
ST VINCENT ISLANDS	VC
ST VINCENT amp THE GREN	VC
ST VINCENT amp THE GRENAD	VC
STA CRUZ BOLIVIA	BO
STANISLAUS COUNTY CALIFORNIA USA	US
STCHRISTOPHERNEVIS	KN
STLOUIS USA	US
STLUCIA	LC
STOCKHOLM SWEDEN	SE
STOKEONTRENT ENGLAND	GB
STOMÉ E PRÍNCIPE	ST
STORRS CONN USA	US
STP	ST
STPIETERSVOEREN BELGIUM	BE
STREMY BELGIUM	BE
STUTTGART GERMANY	DE
STUTTGARTHOHENHEIM GERMANY	DE
STVINCENT	VC
STVINCENT AND THE	VC
SUAZILANDIA	SZ
SUDÁFRICA	ZA
SUDÁN	SD
SUECIA	SE
SUISSE	CH
SUIZA	CH
SUKAMANDI INDONESIA	ID
SULAWESI	ID
SULAWESI UTARA	ID
SUMATRA	ID
SUMATRA INDONESIA	ID
SUNDSVALL SWEDEN	SE
SUNGEI BULOH MALAYSIA	MY
SUR	SR
SURINA	SR
SURINAM	SR
SURINAME	SR
SURINAME DUTCH GUIANA	SR
SURREY UK	GB
SURUGA BAY JAPAN	JP
SUÈDE	SE
SVALBARD	SJ
SVALBARD AND JAN MAYEN ISLANDS	SJ
SVALBARD ET ÎLE JAN MAYEN	SJ
SVALBARD Y JAN MAYEN	SJ
SVALBARD amp JAN MAYEN ISLANDS	SJ
SVERIGE	SE
SVK	SK
SVN	SI
SWAN ISLAND	US
SWANAMIBIA	NA
SWARTKOPPIES TRANSVAAL SOUTH AFRICA	ZA
SWAZILAND	SZ
SWE	SE
SWEDEN	SE
SWITSERLAND	CH
SWZ	SZ
SYC	SC
SYEMEN	YE
SYR	SY
SYRIA	SY
SYRIANARABREPUBLIC	SY
SYRIE	SY
SYRIENNE, RÉPUBLIQUE ARABE	SY
SÃNÃGAL	SN
SÃNÃGAL FULANI	SN
SÃNÃGAL OUOLOF	SN
SÃNÃGAL PEUPLE PEUL DE LA RÃGION DU SINE SALUM	SN
SÃNÃGAL RÃGION DE THIES PEUPLE DES SÃRÃRES SAFÃN	SN
SÃNÃGAL RÃGION ENTRE LES VILLES KÃDOUGOU ET YUKUNKUN	SN
SÃNÃGAL TOUTE LA ZONE Ã PARTIR DU NORD SÃNÃGAL	SN
SÉNÉGAL	SN
TABASCO MEXICO	MX
TADJIKISTAN	TJ
TADJSSR	TJ
TADZHIKISTAN	TJ
TAHITI	PF
TAILANDIA	TH
TAIWAN	TW
TAIWANPROVINCEOFCHINA	TW
TAIWÁN	TW
TALAIA	PT
TANAZANIA	TZ
TANGANYIKA	TZ
TANZANIA	TZ
TANZANIAUNITEDREPUBLICOF	TZ
TANZANIE	TZ
TANZANIE ARUSHA KILIMANDJARO	TZ
TANZANIE CHAGGA	TZ
TANZANIE DE LEST	TZ
TANZANIE HAYA	TZ
TANZANIE IWAMBIMBEYA DISTRICT	TZ
TANZANIE MAMBAMOSHI DISTRICT	TZ
TANZANIE MARANGU DISTRICT	TZ
TANZANIE MARANGU MOSHI DISTRICT	TZ
TANZANIE MARANGUMOSHI DISTRICT	TZ
TANZANIE MASAI	TZ
TANZANIE MBARALI DISTRICT	TZ
TANZANIE MBEYA DISTRICT	TZ
TANZANIE MBOZI DISTRICT	TZ
TANZANIE MOSHI DISTRICT	TZ
TANZANIE MOSHI RURAL DISTRICT	TZ
TANZANIE MOSHI SANJA JUUHAI DIST	TZ
TANZANIE MWIKAMOSHI DISTRICT	TZ
TANZANIE PAYS DU SIMANJIRO	TZ
TANZANIE RUJAWAMBARALI DISTRICT	TZ
TANZANIE RUJEWAMBARALI	TZ
TANZANIE RUJEWAMBARALI DISTRICT	TZ
TANZANIE SAJA JUU MOSHI DISTRICT	TZ
TANZANIE SAMYA JUU HAI DISTRICT	TZ
TANZANIE SANJA JUU DISTRICT	TZ
TANZANIE SANJA JUU HAI DISTRICT	TZ
TANZANIE SANYA JUU DISTRICT	TZ
TANZANIE SANYA JUU HAI DISTRICT	TZ
TANZANIE SENYA JUU HAI DISTRICT	TZ
TANZANIE URUMOSHI DISTRICT	TZ
TANZANIE WEST KILIMANJARO	TZ
TANZANIE, RÉPUBLIQUE-UNIE DE	TZ
TANZANIEMASAI CHAGGA SUKUMA	TZ
TANZNIA	TZ
TASMANIA	AU
TASMANIA AUSTRALIA	AU
TAYIKISTÁN	TJ
TAÃWAN	TW
TAÏWAN	TW
TAÏWAN, PROVINCE DE CHINE	TW
TCA	TC
TCD	TD
TCHAD	TD
TCHAD PAYS SAR	TD
TCHÈQUE, RÉPUBLIQUE	CZ
TENDE FRANCE	FR
TENDELTI SUDAN	SD
TENNESSEE USA	US
TERR NEW GUINEA	PN
TERRAGONA PROVINCE SPAIN	ES
TERRES AUSTRALES FRANÇAISES	TF
TERRITOIRE BRITANNIQUE DE L'OCÉAN INDIEN	IO
TERRITOIRE PALESTINIEN OCCUPÉ	PS
TERRITORIO BRITÁNICO DEL OCÉANO	IO
TERRITORIOS AUSTRALES FRANCESES	TF
TERRITORIOS PALESTINOS	PS
TEXAS	US
TEXAS USA	US
TGO	TG
THA	TH
THAÃLAND	TH
THAÏLANDE	TH
THE BAHAMAS	BS
THE CANARY ISLANDS	ES
THE CONGO	CD
THE DUTCH WEST INDIES	AN
THE FORMER YUGOSLAV REPUBLIC OF MACEDONIA	MK
THE GREAT PETER GULF THE SEA OF JAPAN RUSSIA	RU
THE NETHERLANDS	NL
THE PHILIPPINE ISLANDS	PH
THE PHILIPPINES	PH
THURSDAY ISLAND	AU
TIBET	CN
TIELT BELGIUM	BE
TIENEN BELGIUM	BE
TIFTON USA	US
TIHANY HUNGARY	HU
TILIB LUCBAN QUEZON PHILIPPINES	PH
TIMOR	TL
TIMOR ORIENTAL	TL
TIMOR-LESTE	TL
TIMOR-ORIENTAL	TL
TJK	TJ
TKL	TK
TKM	TM
TLS	TL
TNAZANIA	TZ
TOGO	TG
TOKELAU	TK
TOKELAU ISLANDS	TK
TOKYO JAPAN	JP
TON	TO
TONGA	TO
TORHOUT BELGIUM	BE
TOSASHIMIZU KOCHI PREF JAPAN	JP
TOULOUSE FRANCE	FR
TOURAINE FRANCE	FR
TRINDAD AND TOBAGO	TT
TRINIDAD	TT
TRINIDAD ADN TOBAGO	TT
TRINIDAD AND TOBAGO	TT
TRINIDAD TOB	TT
TRINIDAD Y TOBAGO	TT
TRINIDAD amp TOBAGO	TT
TRINIDADANDTOBAGO	TT
TRINIDADTOBAGO	TT
TRINITÉ-ET-TOBAGO	TT
TRISTAN DA CUNHA	SH
TRURO USA	US
TSHELA ZAIRE	CD
TTO	TT
TUAMOTO IS	PF
TUAMOTU ISL	PF
TUAMOTU ISLANDS	PF
TUBUAI ISL	PF
TUN	TN
TUNESIÃ	TN
TUNIS	TN
TUNISIE	TN
TUR	TR
TURKANA KENYA	KE
TURKMENISTÁN	TM
TURKMENIYA	TM
TURKMÉNISTAN	TM
TURKS AND CAICOS	TC
TURKS AND CAICOS IDS	TC
TURKS AND CIACOS IDS	TC
TURKS CAICOS	TC
TURKS-ET-CAÏCOS, ÎLES	TC
TURNHOUT BELGIUM	BE
TURQUIA	TR
TURQUIE	TR
TURQUÍA	TR
TURRIFF SCOTLAND UK	GB
TUV	TV
TUVALU	TV
TWN	TW
TZA	TZ
TZANEEN NORTHERN PROVINCE SOUTH AFRICA	ZA
TÚNEZ	TN
U S A	US
U S S R	RU
UBON RATCHATHANI THAILAND	TH
UCRANIA	UA
UDDEVALLA SWEDEN	SE
UDNY STATION SCOTLAND UK	GB
UGA	UG
UGANAD	UG
UGANDA	UG
UGANDA ITESO	UG
UGANDA SO	UG
UK	GB
UK ENGLAND	GB
UK ENGLD WAL	GB
UK NO IRELD	GB
UK SCOTLAND	GB
UKR	UA
UKRA	UA
UKRAINE	UA
UKRANIAN SSR	UA
UMEA SWEDEN	SE
UMEÃ SWEDEN	SE
UMI	UM
UNITED KINGDOM OF GREAT BRITAIN AND NORTHERN IRELAND	GB
UNITED KINGKOM	GB
UNITED REPUBLIC OF TANZANIA	TZ
UNITED STATE	US
UNITED STATES HAWAII	US
UNITED STATES OF AMERICA	US
UNITED STATES VIRGIN ISLANDS	VI
UNITEDKINGDOM	GB
UNITEDSTATES	US
UNIVERSITY LAKE BATON ROUGE USA	US
UNIVERSITY OF WASHINGTON HATCHERY USA	US
UNIVERSITY OF WISCONSIN USA	US
UNTD ARAB EM	AE
UPPER CONGO	CD
UPPER EGYPT	EG
UPPER VOLTA	BF
UPPSALA SWEDEN	SE
URAGUAY	UY
URBANA ILLINOIS USA	US
URUGUAY	UY
URY	UY
US ADMINISTERED ISLANDS	UM
US LINE ISL	KI
US MINOR IS	UM
US MISC PAC	UM
US TRUST TERRITORY	UM
US TRUST TERRITORY OF THE PACIFIC	UM
US VIRGIN IDS	VI
US VIRGIN IS	VI
US VIRGIN ISLANDS	VI
USA	US
USADMINISTERED ISLANDS IN THE CENTRAL PACIFIC	UM
USBEKISTAN	UZ
USMARIANAS ISLANDS	US
USSR	RU
USTRUST TERRITORY	UM
USTRUST TERRITORY OF THE PACIFIC	UM
USVIRGIN ISLANDS	VI
UTAH	US
UTAH USA	US
UZB	UZ
UZBEKISTÁN	UZ
VALENCIA SPAIN	ES
VANCOUVER BRITISH COLUMBIA CANADA	CA
VANCOUVER CANADA	CA
VANTAA FINLAND	FI
VANUATA	VU
VANUATU	VU
VANUATUNEW HEBRIDES	VU
VANUTAU	VU
VARASANI INDIA	IN
VASTERAS SWEDEN	SE
VAT	VA
VATICAN	VA
VAUDIGNIES BELGIUM	BE
VCT	VC
VEN	VE
VENEZEULA	VE
VENEZUELA	VE
VENEZUELA BOLIVARIAN REPUBLIC OF	VI
VENEZUELA, RÉPUBLIQUE BOLIVARIENNE DU	VE
VENEZUELLA	VE
VENICE	IT
VENZUELA	VE
VERLAINE BELGIUM	BE
VERMONT USA	US
VESTFOLD HILLS ANTARCTICA	AQ
VESTFOLD HILLS ANTARTICA	AQ
VEURNE BELGIUM	BE
VGB	VG
VICTORIA AUSTRALIA	AU
VIET NAM	VN
VIETNAM	VN
VIGO SPAIN	ES
VILLAFRANCA NAVARRA SPAIN	ES
VILLAGE DE MOUMPOUTOU LE LONG DE LA RIVIÃRE	CG
VILLEGOUGE GIRONDE FRANCE	FR
VIR	VI
VIRGINIA	US
VIRGINIA USA	US
VIÊT NAM	VN
VIÊTNAM	VN
VNM	VN
VOGEZEN	FR
VOLVIC CLAIRVIC SPRING FRANCE	FR
VUT	VU
VYLE EN THAROUL BELGIUM	BE
VÃLBERG SWEDEN	SE
VÃSTERAS SWEDEN	SE
VÃXJÃ SWEDEN	SE
VÃZON BELGIUM	BE
VÉNÉZUÉLA	VE
W AUSTRALIA	AU
WADI NATRUN EGYPT	EG
WAGENINGEN THE NETHERLANDS	NL
WAIRAKEI NEW ZEALAND	NZ
WAKE ATOLL	US
WAKE I	US
WAKE ID	US
WALES	GB
WALES UK	GB
WALGERIA	DZ
WALLIS AND FUTUNA ISLANDS	WF
WALLIS ET FUTUNA	WF
WALLIS FUT I	WF
WALLIS Y FUTUNA	WF
WAREGEM BELGIUM	BE
WARWICK ENGLAND	GB
WARWICK UNIVERSITY UK	GB
WASHINGTON DC USA	US
WASHINGTON STATE USA	US
WASHINGTON USA	US
WATFORD UK	GB
WELLESBOURNE UK	GB
WEST AUSTRALIA	AU
WEST BENGAL INDIA	IN
WEST CAROLINE ISLAND	PW
WEST GERMANY	DE
WEST INDIA	IN
WEST INDIESSAINTTHOMAS	VI
WEST JAVA INDONESIA	ID
WEST MADAGASCAR	MG
WEST MALAYSIA	MY
WEST SAHARA	EH
WEST SCOTLAND SEA LOCH	GB
WEST SUMATRA INDONESIA	ID
WEST VIRGINIA	US
WESTERN AUSTRALIA	AU
WESTERN CAPRIVI NAMIBIA	NA
WESTERN GREENLAND	GL
WESTERN MALAYSIA	MY
WESTERN MEDITERRANEAN SEA FRANCE	FR
WESTERN PAKISTAN	PK
WESTERN SAMOA	WS
WESTERN SOMOA	WS
WESTKERKE BELGIUM	BE
WESTPAKISTAN	PK
WHARMINDA SOUTH AUSTRALIA	AU
WINDHOEK NAMIBIA	NA
WINSLOW NEW ZEALAND	NZ
WISCONSIN USA	US
WLF	WF
WMALAYSIA	MY
WNORTHAMERICA	US
WOMMELGEM BELGIUM	BE
WOODS HOLE MASSACHUSETTS USA	US
WORTHING ENGLAND	GB
WPALKISTAN	PK
WREXHAM UK	GB
WSM	WS
WYOMING	US
XILINHOT MONGOLIA CHINA	MN
XINJIANG CHINA	CN
YELLOWSTONE NATIONAL PARK WYOMING USA	US
YELLOWSTONE PARK USA	US
YEM	YE
YEMAN	YE
YEMEN	YE
YEMEN NORTHSOUTH	YE
YEMEN SOUTH	YE
YIBUTI	DJ
YUGOSLAVIA CROATIA	HR
YVES GOMEZÃE WALCOURT BELGIUM	BE
YVOIR BELGIUM	BE
YÉMEN	YE
ZAF	ZA
ZAIRE	CD
ZAIRE BELGIAN CONGO	CD
ZAIRETETURI FORÃªT DE LITURI	CD
ZAMBIA	ZM
ZAMBIA N RHODESIA	ZM
ZAMBIE	ZM
ZANZIBAR	TZ
ZAÃRE	CD
ZAÃRE AUTOUR DU VILLAGE ANDIRI PRÃS DE NDUYE ITURI	CD
ZAÃRE BASCONGO	CD
ZAÃRE ITURI	CD
ZAÃRE ITURI RÃPUBLIQUE DÃMOCRATIQUE DU CONGO	CD
ZAÃRE KATANGA RÃPUBLIQUE DÃMOCRATIQUE DU CONGO	CD
ZAÃRE KISANGANI RÃP DÃMOCRATIQUE DU CONGO	CD
ZAÃRE NDUYE ZONE DE MAMBASA FORÃªT DE LITURI	CD
ZAÃRE ORIENTAL RÃPUBLIQUE DÃMOCRATIQUE DU CONGO	CD
ZAÃRE RÃP DÃMOCRATIQUE DU CONGO	CD
ZAÃRE RÃP DÃMOCRATIQUE DU CONGO CONGO BELGE	CD
ZAÃRE RÃP DÃMOCRATIQUE DU CONGO SUD KIVU	CD
ZAÃRE RÃPUBLIQUE DÃMOCRATIQUE DU CONGO	CD
ZAÃRE SHABA	CD
ZAÃRE SUD KIVU RÃPUBLIQUE DÃMOCRATIQUE DU CONGO	CD
ZAÏRE	CD
ZELE BELGIUM	BE
ZEVEKOTE BELGIUM	BE
ZHEJIANG CHINA	CN
ZIMBABUE	ZW
ZIMBABWE	ZW
ZIMBABWE RHODESIA	ZW
ZMB	ZM
ZOERSEL BELGIUM	BE
ZONDEREIGEN BELGIUM	BE
ZOTTEGEM BELGIUM	BE
ZR	CD
ZUID PERZIÃ	IR
ZWE	ZW
ZWEVEGEM BELGIUM	BE
ZWOLLE THE NETHERLANDS	NL
ZÃRICH SWITZERLAND	CH
ÃREBRO SWEDEN	SE
ÃSTERREICH	AT
ÃSTERSUND SWEDEN	SE
ÅLAND	AX
ÅLAND, ÎLES	AX
ÉGYPTE	EG
ÉMIRATS ARABES UNIS	AE
ÉQUATEUR	EC
ÉRYTHRÉE	ER
ÉTATS FÉDÉRÉS DE MICRONÉSIE	FM
ÉTATS-UNIS	US
ÉTHIOPIE	ET
ÎLE BOUVET	BV
ÎLE CHRISTMAS	CX
ÎLE DE MAN	IM
ÎLE HEARD	HM
ÎLE NORFOLK	NF
ÎLES CAÏMANS	KY
ÎLES COCOS	CC
ÎLES COOK	CK
ÎLES FALKLAND	FK
ÎLES FÉROÉ	FO
ÎLES HEARD ET MACDONALD	HM
ÎLES KEELING	CC
ÎLES MACDONALD	HM
ÎLES MALOUINES	FK
ÎLES MARIANNES DU NORD	MP
ÎLES MARSHALL	MH
ÎLES MINEURES ÉLOIGNÉES DES ÉTATS-UNIS	UM
ÎLES SALOMON	SB
ÎLES SANDWICH DU SUD	GS
ÎLES TURKS-ET-CAÏCOS	TC
ÎLES VIERGES BRITANNIQUES	VG
ÎLES VIERGES DES ÉTATS-UNIS	VI
ÎLES ÅLAND	AX
ÖSTERREICH	AT
